MatchID,Date,HomeTeam,AwayTeam,FTHG,FTAG,FTR,AT_match_played,AT_goal_against,HT_goal_against,HT_goal_differnece,AT_current_standing,HT_match_played,AT_goal_differnece,AT_goal_for,HT_current_standing,HT_goal_for
0,20/08/94,Arsenal,Man City,3,0,H,0,0,0,0,0,0,0,0,0,0
1,20/08/94,Chelsea,Norwich,2,0,H,0,0,0,0,0,0,0,0,0,0
2,20/08/94,Coventry,Wimbledon,1,1,D,0,0,0,0,0,0,0,0,0,0
3,20/08/94,Crystal Palace,Liverpool,1,6,A,0,0,0,0,0,0,0,0,0,0
4,20/08/94,Everton,Aston Villa,2,2,D,0,0,0,0,0,0,0,0,0,0
5,20/08/94,Ipswich,Nott'm Forest,0,1,A,0,0,0,0,0,0,0,0,0,0
6,20/08/94,Man United,QPR,2,0,H,0,0,0,0,0,0,0,0,0,0
7,20/08/94,Sheffield Weds,Tottenham,3,4,A,0,0,0,0,0,0,0,0,0,0
8,20/08/94,Southampton,Blackburn,1,1,D,0,0,0,0,0,0,0,0,0,0
9,20/08/94,West Ham,Leeds,0,0,D,0,0,0,0,0,0,0,0,0,0
10,21/08/94,Leicester,Newcastle,1,3,A,0,0,0,0,0,0,0,0,0,0
11,22/08/94,Nott'm Forest,Man United,1,1,D,1,0,0,1,3,1,2,2,3,1
12,23/08/94,Blackburn,Leicester,3,0,H,1,3,1,0,0,1,-2,1,1,1
13,23/08/94,Leeds,Arsenal,1,0,H,1,0,0,0,3,1,3,3,1,0
14,23/08/94,Wimbledon,Ipswich,1,1,D,1,1,1,0,0,1,-1,0,1,1
15,24/08/94,Aston Villa,Southampton,1,1,D,1,1,2,0,1,1,0,1,1,2
16,24/08/94,Man City,West Ham,3,0,H,1,0,3,-3,1,1,0,0,0,0
17,24/08/94,Newcastle,Coventry,4,0,H,1,1,1,2,1,1,0,1,3,3
18,24/08/94,Norwich,Crystal Palace,0,0,D,1,6,2,-2,0,1,-5,1,0,0
19,24/08/94,QPR,Sheffield Weds,3,2,H,1,4,2,-2,0,1,-1,3,0,0
20,24/08/94,Tottenham,Everton,2,1,H,1,2,3,1,1,1,0,2,3,4
21,27/08/94,Aston Villa,Crystal Palace,1,1,D,2,6,3,0,1,2,-5,1,2,3
22,27/08/94,Blackburn,Coventry,4,0,H,2,5,1,3,1,2,-4,1,4,4
23,27/08/94,Leeds,Chelsea,2,3,A,1,0,0,1,3,2,2,2,4,1
24,27/08/94,Man City,Everton,4,0,H,2,4,3,0,1,2,-1,3,3,3
25,27/08/94,Newcastle,Southampton,5,1,H,2,2,1,6,2,2,0,2,6,7
26,27/08/94,Norwich,West Ham,1,0,H,2,3,2,-2,1,2,-3,0,1,0
27,27/08/94,Nott'm Forest,Leicester,1,0,H,2,6,1,1,0,2,-5,1,4,2
28,27/08/94,QPR,Ipswich,1,2,A,2,2,4,-1,1,2,-1,1,3,3
29,27/08/94,Tottenham,Man United,0,1,A,2,1,4,2,4,2,2,3,6,6
30,27/08/94,Wimbledon,Sheffield Weds,0,1,A,2,7,2,0,0,2,-2,5,2,2
31,28/08/94,Liverpool,Arsenal,3,0,H,2,1,1,5,3,1,2,3,3,6
32,29/08/94,Coventry,Aston Villa,0,1,A,3,4,9,-8,3,3,0,4,1,1
33,30/08/94,Crystal Palace,Leeds,1,2,A,3,3,7,-5,4,3,0,3,2,2
34,30/08/94,Everton,Nott'm Forest,1,2,A,3,1,8,-5,7,3,2,3,1,3
35,30/08/94,Ipswich,Tottenham,1,3,A,3,5,3,0,6,3,1,6,4,3
36,31/08/94,Arsenal,Blackburn,0,0,D,3,1,4,-1,7,3,7,8,3,3
37,31/08/94,Chelsea,Man City,3,0,H,3,3,2,3,6,2,4,7,6,5
38,31/08/94,Leicester,QPR,1,1,D,3,6,7,-6,3,3,-2,4,0,1
39,31/08/94,Man United,Wimbledon,3,0,H,3,3,1,3,2,3,-1,2,7,4
40,31/08/94,Sheffield Weds,Norwich,0,0,D,3,2,7,-1,4,3,-1,1,3,6
41,31/08/94,Southampton,Liverpool,0,2,A,2,1,7,-4,6,3,8,9,2,3
42,31/08/94,West Ham,Newcastle,1,3,A,3,2,4,-4,9,3,10,12,1,0
43,10/09/94,Aston Villa,Ipswich,2,0,H,4,6,4,1,4,4,-2,4,6,5
44,10/09/94,Blackburn,Everton,3,0,H,4,10,1,7,1,4,-6,4,8,8
45,10/09/94,Liverpool,West Ham,0,0,D,4,7,1,10,1,3,-6,1,9,11
46,10/09/94,Man City,Crystal Palace,1,1,D,4,9,6,1,2,4,-6,3,6,7
47,10/09/94,Newcastle,Chelsea,4,2,H,3,2,3,12,9,4,6,8,12,15
48,10/09/94,Norwich,Arsenal,0,0,D,4,4,2,-1,4,4,-1,3,5,1
49,10/09/94,Nott'm Forest,Sheffield Weds,4,1,H,4,7,2,3,4,4,-1,6,10,5
50,10/09/94,QPR,Coventry,2,2,D,4,10,7,-2,1,4,-9,1,4,5
51,10/09/94,Wimbledon,Leicester,2,1,H,4,8,6,-4,1,4,-6,2,2,2
52,11/09/94,Leeds,Man United,2,1,H,4,1,4,1,10,4,6,7,7,5
53,12/09/94,Tottenham,Southampton,1,2,A,4,9,6,3,2,4,-6,3,9,9
54,17/09/94,Coventry,Leeds,2,1,H,5,5,12,-9,10,5,2,7,2,3
55,17/09/94,Crystal Palace,Wimbledon,0,0,D,5,7,10,-6,5,5,-3,4,3,4
56,17/09/94,Everton,QPR,2,2,D,5,9,13,-9,5,5,-2,7,1,4
57,17/09/94,Leicester,Tottenham,3,1,H,5,8,10,-7,9,5,2,10,1,3
58,17/09/94,Man United,Liverpool,2,0,H,4,1,3,5,10,5,10,11,10,8
59,17/09/94,Sheffield Weds,Man City,1,1,D,5,7,11,-4,7,5,1,8,4,7
60,17/09/94,Southampton,Nott'm Forest,1,1,D,5,3,10,-5,13,5,6,9,5,5
61,17/09/94,West Ham,Aston Villa,1,0,H,5,4,7,-6,9,5,3,7,2,1
62,18/09/94,Arsenal,Newcastle,2,3,A,5,5,4,-1,15,5,14,19,5,3
63,18/09/94,Chelsea,Blackburn,1,2,A,5,1,6,4,11,4,10,11,9,10
64,19/09/94,Ipswich,Norwich,1,2,A,5,2,8,-4,6,5,-1,1,4,4
65,24/09/94,Blackburn,Aston Villa,3,1,H,6,5,2,11,9,6,2,7,14,13
66,24/09/94,Coventry,Southampton,1,3,A,6,11,13,-8,6,6,-5,6,5,5
67,24/09/94,Crystal Palace,Chelsea,0,1,A,5,8,10,-6,9,6,3,11,4,4
68,24/09/94,Everton,Leicester,1,1,D,6,11,15,-9,4,6,-5,6,2,6
69,24/09/94,Ipswich,Man United,3,2,H,6,3,10,-5,13,6,7,10,4,5
70,24/09/94,Man City,Norwich,2,0,H,6,3,8,1,9,6,0,3,8,9
71,24/09/94,Newcastle,Liverpool,1,1,D,5,3,7,15,10,6,8,11,18,22
72,24/09/94,QPR,Wimbledon,0,1,A,6,7,11,-2,6,6,-3,4,6,9
73,24/09/94,Tottenham,Nott'm Forest,1,4,A,6,4,11,0,14,6,6,10,9,11
74,25/09/94,West Ham,Arsenal,0,2,A,6,7,7,-5,5,6,-2,5,5,2
75,26/09/94,Sheffield Weds,Leeds,1,1,D,6,7,12,-4,10,6,1,8,5,8
76,01/10/94,Arsenal,Crystal Palace,1,2,A,7,11,7,0,4,7,-7,4,8,7
77,01/10/94,Aston Villa,Newcastle,0,2,A,7,8,8,0,19,7,15,23,9,8
78,01/10/94,Leeds,Man City,2,0,H,7,8,8,1,11,7,3,11,11,9
79,01/10/94,Liverpool,Sheffield Weds,4,1,H,7,13,4,8,6,6,-4,9,11,12
80,01/10/94,Man United,Everton,2,0,H,7,16,6,6,3,7,-9,7,13,12
81,01/10/94,Norwich,Blackburn,2,1,H,7,3,5,-2,17,7,13,16,9,3
82,01/10/94,Southampton,Ipswich,3,1,H,7,12,12,-3,7,7,-4,8,9,9
83,01/10/94,Wimbledon,Tottenham,1,2,A,7,15,7,-2,9,7,-3,12,9,5
84,02/10/94,Chelsea,West Ham,1,2,A,7,9,8,4,5,6,-7,2,12,12
85,02/10/94,Nott'm Forest,QPR,3,2,H,7,12,5,9,6,7,-3,9,17,14
86,03/10/94,Leicester,Coventry,2,2,D,7,16,12,-5,5,7,-10,6,5,7
87,08/10/94,Chelsea,Leicester,4,0,H,8,14,10,3,6,7,-5,9,12,13
88,08/10/94,Liverpool,Aston Villa,3,2,H,8,10,5,11,9,7,-2,8,14,16
89,08/10/94,Man City,Nott'm Forest,3,3,D,8,7,10,1,20,8,10,17,11,11
90,08/10/94,Norwich,Leeds,2,1,H,8,8,6,-1,14,8,3,11,12,5
91,08/10/94,Sheffield Weds,Man United,1,0,H,8,6,17,-7,16,8,8,14,6,10
92,08/10/94,Southampton,Everton,2,0,H,8,18,13,-1,3,8,-11,7,12,12
93,08/10/94,Tottenham,QPR,1,1,D,8,15,16,-2,6,8,-4,11,12,14
94,08/10/94,West Ham,Crystal Palace,1,0,H,8,12,10,-6,7,8,-6,6,8,4
95,08/10/94,Wimbledon,Arsenal,1,3,A,8,9,9,-3,8,8,-1,8,9,6
96,09/10/94,Newcastle,Blackburn,1,1,D,8,5,8,17,17,8,12,17,22,25
97,10/10/94,Coventry,Ipswich,2,0,H,8,15,18,-10,7,8,-6,9,6,8
98,15/10/94,Arsenal,Chelsea,3,1,H,8,10,10,1,15,9,7,17,11,11
99,15/10/94,Aston Villa,Norwich,1,1,D,9,7,13,-3,15,9,0,7,9,10
100,15/10/94,Blackburn,Liverpool,3,2,H,8,7,6,12,17,9,12,19,18,18
101,15/10/94,Crystal Palace,Newcastle,0,1,A,9,9,13,-7,23,9,17,26,7,6
102,15/10/94,Everton,Coventry,0,2,A,9,18,20,-13,9,9,-8,10,3,7
103,15/10/94,Leeds,Tottenham,1,1,D,9,17,10,2,13,9,-2,15,14,12
104,15/10/94,Leicester,Southampton,4,3,H,9,13,18,-9,15,9,1,14,6,9
105,15/10/94,Man United,West Ham,1,0,H,9,10,7,7,11,9,-5,5,16,14
106,15/10/94,QPR,Man City,1,2,A,9,13,16,-4,12,9,1,14,7,12
107,16/10/94,Ipswich,Sheffield Weds,1,2,A,9,17,17,-8,9,9,-6,11,7,9
108,17/10/94,Nott'm Forest,Wimbledon,3,1,H,9,12,10,10,9,9,-5,7,21,20
109,22/10/94,Aston Villa,Nott'm Forest,0,2,A,10,11,14,-3,24,10,12,23,10,11
110,22/10/94,Crystal Palace,Everton,1,0,H,10,22,14,-8,3,10,-15,7,7,6
111,22/10/94,Liverpool,Wimbledon,3,0,H,10,15,10,11,9,9,-7,8,17,21
112,22/10/94,Man City,Tottenham,5,2,H,10,18,14,2,14,10,-2,16,15,16
113,22/10/94,Newcastle,Sheffield Weds,2,1,H,10,18,9,18,12,10,-5,13,26,27
114,22/10/94,Norwich,QPR,4,2,H,10,18,8,0,7,10,-5,13,16,8
115,22/10/94,West Ham,Southampton,2,0,H,10,17,11,-6,15,10,0,17,11,5
116,23/10/94,Arsenal,Coventry,2,1,H,10,18,11,3,12,10,-6,12,14,14
117,23/10/94,Blackburn,Man United,2,4,A,10,7,8,13,19,10,8,15,21,21
118,23/10/94,Chelsea,Ipswich,2,0,H,10,19,13,5,7,9,-9,10,15,18
119,24/10/94,Leeds,Leicester,2,1,H,10,21,11,2,9,10,-8,13,15,13
120,29/10/94,Coventry,Man City,1,0,H,11,16,20,-7,18,11,5,21,12,13
121,29/10/94,Everton,Arsenal,1,1,D,11,12,23,-16,17,11,4,16,3,7
122,29/10/94,Ipswich,Liverpool,1,3,A,10,10,21,-11,20,11,14,24,7,10
123,29/10/94,Leicester,Crystal Palace,0,1,A,11,14,23,-9,10,11,-7,7,9,14
124,29/10/94,Man United,Newcastle,2,0,H,11,10,9,10,29,11,19,29,22,19
125,29/10/94,Nott'm Forest,Blackburn,0,2,A,11,12,11,14,21,11,11,23,27,25
126,29/10/94,QPR,Aston Villa,2,0,H,11,16,22,-7,10,11,-5,11,7,15
127,29/10/94,Sheffield Weds,Chelsea,1,1,D,10,13,20,-6,18,11,7,20,12,14
128,29/10/94,Southampton,Leeds,1,3,A,11,12,19,-2,18,11,3,15,15,17
129,29/10/94,Tottenham,West Ham,3,1,H,11,11,23,-5,14,11,-4,7,14,18
130,30/10/94,Wimbledon,Norwich,1,0,H,11,10,18,-10,19,11,2,12,9,8
131,31/10/94,QPR,Liverpool,2,1,H,11,11,22,-5,23,12,16,27,10,17
132,01/11/94,Everton,West Ham,1,0,H,12,14,24,-16,14,12,-6,8,4,8
133,01/11/94,Ipswich,Leeds,2,0,H,12,13,24,-13,21,12,5,18,7,11
134,02/11/94,Coventry,Crystal Palace,1,4,A,12,14,20,-6,13,12,-6,8,15,14
135,02/11/94,Sheffield Weds,Blackburn,0,1,A,12,12,21,-6,24,12,13,25,13,15
136,02/11/94,Southampton,Norwich,1,1,D,12,11,22,-4,19,12,1,12,15,18
137,05/11/94,Blackburn,Tottenham,2,0,H,12,24,12,14,17,13,-3,21,27,26
138,05/11/94,Crystal Palace,Ipswich,3,0,H,13,24,15,-3,10,13,-11,13,16,12
139,05/11/94,Leeds,Wimbledon,3,1,H,12,18,15,3,12,13,-9,9,21,18
140,05/11/94,Liverpool,Nott'm Forest,1,0,H,12,13,13,15,27,12,12,25,23,28
141,05/11/94,Man City,Southampton,3,3,D,13,23,17,4,16,12,-4,19,18,21
142,05/11/94,Newcastle,QPR,2,1,H,13,23,12,17,13,12,-4,19,29,29
143,05/11/94,Norwich,Everton,0,0,D,13,24,12,1,7,13,-15,9,20,13
144,05/11/94,West Ham,Leicester,1,0,H,12,24,15,-7,9,13,-10,14,14,8
145,06/11/94,Arsenal,Sheffield Weds,0,0,D,13,22,13,4,13,12,-7,15,18,17
146,06/11/94,Aston Villa,Man United,1,2,A,12,9,18,-7,25,12,12,21,10,11
147,06/11/94,Chelsea,Coventry,2,2,D,13,24,14,7,15,11,-9,15,19,21
148,07/11/94,Nott'm Forest,Newcastle,0,0,D,13,13,14,11,32,13,18,31,27,25
149,09/11/94,Liverpool,Chelsea,3,1,H,12,16,13,16,20,13,7,23,26,29
150,09/11/94,Wimbledon,Aston Villa,4,3,H,13,20,21,-11,10,13,-8,12,12,10
151,10/11/94,Man United,Man City,5,0,H,13,20,10,13,19,13,4,24,28,23
152,19/11/94,Coventry,Norwich,1,0,H,14,12,26,-9,21,14,1,13,16,17
153,19/11/94,Ipswich,Blackburn,1,3,A,14,12,27,-14,30,14,16,28,10,13
154,19/11/94,Man United,Crystal Palace,3,0,H,14,15,10,18,19,14,0,15,31,28
155,19/11/94,Nott'm Forest,Chelsea,0,1,A,13,19,14,11,20,14,5,24,28,25
156,19/11/94,QPR,Leeds,3,2,H,14,16,25,-5,24,14,5,21,13,20
157,19/11/94,Sheffield Weds,West Ham,1,0,H,14,15,22,-7,17,14,-6,9,14,15
158,19/11/94,Southampton,Arsenal,1,0,H,13,13,26,-4,19,14,4,17,17,22
159,19/11/94,Tottenham,Aston Villa,3,4,A,14,24,26,-5,10,13,-9,15,17,21
160,19/11/94,Wimbledon,Newcastle,3,2,H,14,13,24,-10,33,14,18,31,15,14
161,20/11/94,Leicester,Man City,0,1,A,14,25,25,-11,19,13,-1,24,9,14
162,21/11/94,Everton,Liverpool,2,0,H,14,14,24,-15,29,14,18,32,8,9
163,23/11/94,Leicester,Arsenal,2,1,H,14,14,26,-12,19,14,3,17,9,14
164,23/11/94,Tottenham,Chelsea,0,0,D,14,19,30,-6,23,14,6,25,17,24
165,26/11/94,Arsenal,Man United,0,0,D,15,10,16,2,34,15,21,31,19,18
166,26/11/94,Blackburn,QPR,4,0,H,15,27,13,18,16,15,-4,23,33,31
167,26/11/94,Chelsea,Everton,0,1,A,15,24,19,6,11,15,-13,11,24,25
168,26/11/94,Crystal Palace,Southampton,0,0,D,15,26,18,-3,20,15,-3,23,19,15
169,26/11/94,Leeds,Nott'm Forest,1,0,H,15,15,19,4,28,15,10,25,24,23
170,26/11/94,Liverpool,Tottenham,1,1,D,15,30,16,16,18,15,-6,24,29,32
171,26/11/94,Man City,Wimbledon,2,0,H,15,26,25,0,18,15,-9,17,22,25
172,26/11/94,Newcastle,Ipswich,1,1,D,15,30,16,17,10,15,-16,14,33,33
173,26/11/94,Norwich,Leicester,2,1,H,15,27,13,0,12,15,-11,16,21,13
174,26/11/94,West Ham,Coventry,0,1,A,15,26,16,-7,19,15,-8,18,17,9
175,27/11/94,Aston Villa,Sheffield Weds,1,1,D,15,22,27,-8,17,15,-6,16,13,19
176,03/12/94,Coventry,Liverpool,1,1,D,16,17,26,-7,30,16,16,33,22,19
177,03/12/94,Ipswich,Man City,1,2,A,16,25,31,-16,25,16,2,27,11,15
178,03/12/94,Leicester,Aston Villa,1,1,D,16,28,29,-12,14,16,-8,20,12,17
179,03/12/94,Man United,Norwich,1,0,H,16,14,10,21,24,16,1,15,35,31
180,03/12/94,Nott'm Forest,Arsenal,2,2,D,16,16,16,9,20,16,2,18,28,25
181,03/12/94,Sheffield Weds,Crystal Palace,1,0,H,16,18,23,-6,20,16,-3,15,18,17
182,03/12/94,Southampton,Chelsea,0,1,A,16,20,26,-3,24,16,5,25,21,23
183,03/12/94,Tottenham,Newcastle,4,2,H,16,17,31,-6,34,16,17,34,19,25
184,03/12/94,Wimbledon,Blackburn,0,3,A,16,13,28,-11,36,16,22,35,18,17
185,04/12/94,Everton,Leeds,3,0,H,16,19,24,-12,27,16,5,24,14,12
186,04/12/94,QPR,West Ham,2,1,H,16,17,31,-8,17,16,-8,9,16,23
187,10/12/94,Aston Villa,Everton,0,0,D,17,24,29,-8,17,17,-9,15,15,21
188,10/12/94,Blackburn,Southampton,3,2,H,17,27,13,25,21,17,-4,23,39,38
189,10/12/94,Leeds,West Ham,2,2,D,17,19,22,2,17,17,-9,10,27,24
190,10/12/94,Newcastle,Leicester,3,1,H,17,30,21,15,13,17,-12,18,34,36
191,10/12/94,Norwich,Chelsea,3,0,H,17,20,15,0,27,17,6,26,24,15
192,10/12/94,Nott'm Forest,Ipswich,4,1,H,17,33,18,9,11,17,-17,16,29,27
193,10/12/94,QPR,Man United,2,3,A,17,10,32,-7,38,17,22,32,19,25
194,10/12/94,Tottenham,Sheffield Weds,3,1,H,17,23,33,-4,21,17,-5,18,22,29
195,10/12/94,Wimbledon,Coventry,2,0,H,17,27,31,-14,23,17,-7,20,18,17
196,11/12/94,Liverpool,Crystal Palace,0,0,D,17,19,18,16,20,17,-4,15,31,34
197,12/12/94,Man City,Arsenal,1,2,A,17,18,26,3,21,17,2,20,28,29
198,16/12/94,Ipswich,Wimbledon,2,2,D,18,31,37,-20,21,18,-12,19,11,17
199,17/12/94,Arsenal,Leeds,1,3,A,18,24,19,3,28,18,2,26,24,22
200,17/12/94,Coventry,Newcastle,0,0,D,18,22,29,-9,37,18,17,39,23,20
201,17/12/94,Crystal Palace,Norwich,0,1,A,18,15,19,-4,27,18,3,18,21,15
202,17/12/94,Everton,Tottenham,0,0,D,18,34,24,-9,25,18,-2,32,18,15
203,17/12/94,Leicester,Blackburn,0,0,D,18,15,33,-14,42,18,26,41,13,19
204,17/12/94,Man United,Nott'm Forest,1,2,A,18,19,12,23,32,18,12,31,41,35
205,17/12/94,Sheffield Weds,QPR,0,2,A,18,35,26,-7,19,18,-8,27,21,19
206,17/12/94,West Ham,Man City,3,0,H,18,28,21,-9,28,18,2,30,18,12
207,18/12/94,Chelsea,Liverpool,0,0,D,18,18,23,3,32,18,16,34,27,26
208,19/12/94,Southampton,Aston Villa,2,1,H,18,29,30,-5,16,18,-8,21,21,25
209,26/12/94,Arsenal,Aston Villa,0,0,D,19,31,22,1,16,19,-9,22,24,23
210,26/12/94,Chelsea,Man United,2,3,A,19,14,23,3,41,19,22,36,28,26
211,26/12/94,Coventry,Nott'm Forest,0,0,D,19,20,29,-9,35,19,13,33,24,20
212,26/12/94,Crystal Palace,QPR,0,0,D,19,35,20,-5,22,19,-6,29,21,15
213,26/12/94,Everton,Sheffield Weds,1,4,A,19,28,24,-9,21,19,-9,19,19,15
214,26/12/94,Leeds,Newcastle,0,0,D,19,22,25,4,38,19,17,39,31,29
215,26/12/94,Leicester,Liverpool,1,2,A,19,18,33,-14,33,19,16,34,14,19
216,26/12/94,Man City,Blackburn,1,3,A,19,15,31,-1,43,19,26,41,28,30
217,26/12/94,Norwich,Tottenham,0,2,A,19,34,15,4,26,19,-2,32,30,19
218,26/12/94,Southampton,Wimbledon,2,3,A,19,33,31,-4,22,19,-12,21,24,27
219,26/12/94,West Ham,Ipswich,1,1,D,19,39,21,-6,12,19,-20,19,21,15
220,27/12/94,Nott'm Forest,Norwich,1,0,H,20,17,20,13,30,20,2,19,36,33
221,27/12/94,Tottenham,Crystal Palace,0,0,D,20,20,34,0,22,20,-5,15,29,34
222,28/12/94,Aston Villa,Chelsea,3,0,H,20,26,31,-9,28,20,2,28,17,22
223,28/12/94,Ipswich,Arsenal,0,2,A,20,22,40,-20,25,20,1,23,13,20
224,28/12/94,Liverpool,Man City,2,0,H,20,34,19,17,28,20,-3,31,36,36
225,28/12/94,Man United,Leicester,1,1,D,20,35,16,23,14,20,-15,20,44,39
226,28/12/94,QPR,Southampton,2,2,D,20,34,35,-6,24,20,-5,29,23,29
227,28/12/94,Sheffield Weds,Coventry,5,1,H,20,29,29,-6,25,20,-9,20,24,23
228,28/12/94,Wimbledon,West Ham,1,0,H,20,22,35,-11,22,20,-6,16,25,24
229,31/12/94,Arsenal,QPR,1,3,A,21,37,22,3,24,21,-6,31,28,25
230,31/12/94,Chelsea,Wimbledon,1,1,D,21,35,29,-1,28,21,-10,25,28,28
231,31/12/94,Coventry,Tottenham,0,4,A,21,34,34,-13,30,21,0,34,25,21
232,31/12/94,Crystal Palace,Blackburn,0,1,A,20,16,20,-5,46,21,28,44,23,15
233,31/12/94,Everton,Ipswich,4,1,H,21,42,28,-12,13,20,-22,20,19,16
234,31/12/94,Leeds,Liverpool,0,2,A,21,19,25,4,39,20,19,38,32,29
235,31/12/94,Leicester,Sheffield Weds,0,1,A,21,30,36,-15,27,21,-2,28,15,21
236,31/12/94,Man City,Aston Villa,2,2,D,21,31,36,-5,20,21,-6,25,28,31
237,31/12/94,Norwich,Newcastle,2,1,H,20,22,18,1,39,21,17,39,30,19
238,31/12/94,Southampton,Man United,2,2,D,21,17,36,-5,45,21,23,40,25,31
239,31/12/94,West Ham,Nott'm Forest,3,1,H,21,20,23,-7,39,21,14,34,22,16
240,02/01/95,Aston Villa,Leeds,0,0,D,21,27,33,-6,32,22,2,29,21,27
241,02/01/95,Blackburn,West Ham,4,2,H,22,24,16,29,25,21,-5,19,49,45
242,02/01/95,Ipswich,Leicester,4,1,H,22,37,46,-25,15,22,-16,21,13,21
243,02/01/95,Liverpool,Norwich,4,0,H,22,19,19,21,33,22,2,21,42,40
244,02/01/95,Newcastle,Man City,0,0,D,22,38,24,16,29,21,-5,33,39,40
245,02/01/95,Nott'm Forest,Crystal Palace,1,0,H,22,21,23,12,23,22,-6,15,39,35
246,02/01/95,Sheffield Weds,Southampton,1,1,D,22,38,30,-1,26,22,-5,33,30,29
247,02/01/95,Tottenham,Arsenal,1,0,H,22,25,34,4,28,22,1,26,33,38
248,02/01/95,Wimbledon,Everton,2,1,H,21,29,36,-10,22,22,-9,20,29,26
249,03/01/95,Man United,Coventry,2,0,H,22,38,19,23,25,22,-17,21,46,42
250,14/01/95,Arsenal,Everton,1,1,D,22,31,26,0,22,23,-10,21,28,26
251,14/01/95,Aston Villa,QPR,2,1,H,22,38,33,-6,27,23,-4,34,22,27
252,14/01/95,Blackburn,Nott'm Forest,3,0,H,23,23,18,31,42,22,13,36,52,49
253,14/01/95,Chelsea,Sheffield Weds,1,1,D,23,31,30,-1,31,22,-1,30,29,29
254,14/01/95,Crystal Palace,Leicester,2,0,H,23,41,22,-7,15,23,-19,22,23,15
255,14/01/95,Leeds,Southampton,0,0,D,23,39,27,2,27,22,-5,34,33,29
256,14/01/95,Liverpool,Ipswich,0,1,A,23,47,19,25,16,23,-22,25,45,44
257,14/01/95,Man City,Coventry,0,0,D,23,40,38,-5,25,23,-19,21,30,33
258,14/01/95,Norwich,Wimbledon,1,2,A,23,37,23,-2,32,23,-9,28,33,21
259,14/01/95,West Ham,Tottenham,1,2,A,23,34,28,-7,36,23,5,39,25,21
260,15/01/95,Newcastle,Man United,1,1,D,23,19,24,16,49,22,25,44,40,40
261,21/01/95,Coventry,Arsenal,0,1,A,24,27,40,-19,29,24,0,27,26,21
262,21/01/95,Everton,Crystal Palace,3,1,H,24,22,32,-10,26,23,-5,17,23,22
263,21/01/95,Ipswich,Chelsea,2,2,D,23,31,47,-21,30,24,-1,30,19,26
264,21/01/95,Nott'm Forest,Aston Villa,1,2,A,24,34,26,10,25,24,-5,29,42,36
265,21/01/95,Sheffield Weds,Newcastle,0,0,D,23,25,32,-1,41,24,16,41,32,31
266,22/01/95,Man United,Blackburn,1,0,H,23,18,20,25,55,24,34,52,50,45
267,23/01/95,West Ham,Sheffield Weds,0,2,A,25,32,30,-8,33,24,-1,31,25,22
268,24/01/95,Arsenal,Southampton,1,1,D,24,39,27,1,28,25,-5,34,32,28
269,24/01/95,Leeds,QPR,4,0,H,23,40,27,2,27,23,-5,35,34,29
270,24/01/95,Liverpool,Everton,0,0,D,24,33,20,24,26,24,-8,25,45,44
271,25/01/95,Aston Villa,Tottenham,1,0,H,24,35,35,-4,39,25,6,41,28,31
272,25/01/95,Chelsea,Nott'm Forest,0,2,A,25,28,33,-1,42,24,9,37,31,32
273,25/01/95,Crystal Palace,Man United,1,1,D,25,20,25,-7,53,25,26,46,26,18
274,25/01/95,Man City,Leicester,0,1,A,24,43,38,-5,15,24,-21,22,31,33
275,25/01/95,Newcastle,Wimbledon,2,1,H,24,38,25,16,35,24,-8,30,42,41
276,25/01/95,Norwich,Coventry,2,2,D,25,41,25,-3,26,24,-20,21,33,22
277,28/01/95,Blackburn,Ipswich,4,1,H,25,49,19,33,20,24,-21,28,55,52
278,01/02/95,Blackburn,Leeds,1,1,D,24,27,20,36,37,25,6,33,58,56
279,01/02/95,Newcastle,Everton,2,0,H,25,33,26,17,27,25,-8,25,45,43
280,04/02/95,Coventry,Chelsea,2,2,D,25,35,43,-20,31,26,-3,32,27,23
281,04/02/95,Everton,Norwich,2,1,H,25,27,35,-10,34,26,-3,24,27,25
282,04/02/95,Ipswich,Crystal Palace,0,2,A,26,26,53,-24,27,26,-7,19,20,29
283,04/02/95,Leicester,West Ham,1,2,A,25,32,43,-20,25,25,-10,22,18,23
284,04/02/95,Man United,Aston Villa,1,0,H,26,35,21,26,31,26,-3,32,54,47
285,04/02/95,Nott'm Forest,Liverpool,1,1,D,25,20,28,11,46,26,24,44,45,39
286,04/02/95,QPR,Newcastle,3,0,H,26,26,44,-9,48,24,19,45,27,35
287,04/02/95,Sheffield Weds,Arsenal,3,1,H,26,28,32,1,33,26,1,29,36,33
288,04/02/95,Southampton,Man City,2,2,D,25,39,40,-5,31,25,-6,33,29,35
289,04/02/95,Wimbledon,Leeds,0,0,D,25,28,40,-9,38,25,6,34,35,31
290,05/02/95,Tottenham,Blackburn,3,1,H,26,21,36,5,59,25,36,57,39,41
291,11/02/95,Arsenal,Leicester,1,1,D,26,45,31,-1,18,27,-21,24,33,30
292,11/02/95,Aston Villa,Wimbledon,7,1,H,26,40,36,-4,36,27,-9,31,31,32
293,11/02/95,Chelsea,Tottenham,1,1,D,26,37,37,-3,42,26,7,44,32,34
294,11/02/95,Crystal Palace,Coventry,0,2,A,27,45,26,-5,28,27,-20,25,30,21
295,11/02/95,Liverpool,QPR,1,1,D,25,44,21,24,30,26,-6,38,47,45
296,11/02/95,Man City,Man United,0,3,A,27,21,41,-6,57,26,27,48,32,35
297,11/02/95,Newcastle,Nott'm Forest,2,1,H,27,29,29,16,46,27,11,40,48,45
298,11/02/95,Norwich,Southampton,2,2,D,26,42,29,-4,30,26,-5,37,34,25
299,12/02/95,Blackburn,Sheffield Weds,3,1,H,27,33,24,34,39,27,3,36,59,58
300,13/02/95,West Ham,Everton,2,2,D,27,36,33,-9,30,26,-9,27,28,24
301,18/02/95,Coventry,West Ham,2,0,H,27,35,45,-18,29,28,-9,26,31,27
302,18/02/95,Sheffield Weds,Aston Villa,1,2,A,28,37,36,1,34,28,2,39,39,37
303,21/02/95,Arsenal,Nott'm Forest,1,0,H,28,31,32,-1,46,28,10,41,34,31
304,22/02/95,Aston Villa,Leicester,4,4,D,27,46,38,3,19,29,-21,25,37,41
305,22/02/95,Blackburn,Wimbledon,2,1,H,27,47,25,36,36,28,-15,32,62,61
306,22/02/95,Leeds,Everton,1,0,H,28,38,28,6,31,26,-9,29,39,34
307,22/02/95,Man City,Ipswich,2,0,H,27,55,44,-9,20,27,-26,29,32,35
308,22/02/95,Norwich,Man United,0,2,A,28,21,31,-4,60,27,30,51,35,27
309,25/02/95,Blackburn,Norwich,0,0,D,28,33,26,37,35,29,-6,27,65,63
310,25/02/95,Coventry,Leicester,4,2,H,28,50,45,-16,20,29,-21,29,34,29
311,25/02/95,Crystal Palace,Arsenal,0,3,A,29,32,28,-7,37,28,0,32,30,21
312,25/02/95,Everton,Man United,1,0,H,29,21,39,-10,63,29,32,53,31,29
313,25/02/95,Ipswich,Southampton,2,1,H,27,44,57,-28,31,28,-5,39,20,29
314,25/02/95,Man City,Leeds,0,0,D,27,28,44,-7,42,28,7,35,35,37
315,25/02/95,Newcastle,Aston Villa,3,1,H,30,42,30,17,38,28,3,45,51,47
316,25/02/95,Sheffield Weds,Liverpool,1,2,A,27,22,38,0,48,29,24,46,39,38
317,25/02/95,Tottenham,Wimbledon,1,2,A,28,49,38,7,36,27,-16,33,43,45
318,25/02/95,West Ham,Chelsea,1,2,A,27,38,37,-11,33,28,-3,35,29,26
319,26/02/95,QPR,Nott'm Forest,1,1,D,29,32,45,-6,46,26,9,41,31,39
320,28/02/95,Ipswich,Newcastle,0,2,A,29,31,58,-27,54,29,19,50,23,31
321,04/03/95,Aston Villa,Blackburn,0,1,A,30,26,45,1,66,31,37,63,38,46
322,04/03/95,Leeds,Sheffield Weds,0,1,A,30,40,28,7,39,28,-1,39,43,35
323,04/03/95,Leicester,Everton,2,2,D,30,39,54,-23,34,29,-9,30,20,31
324,04/03/95,Liverpool,Newcastle,2,0,H,30,31,23,25,57,28,21,52,51,48
325,04/03/95,Man United,Ipswich,9,0,H,30,60,22,31,23,30,-29,31,63,53
326,04/03/95,Norwich,Man City,1,1,D,29,44,33,-6,36,29,-7,37,36,27
327,04/03/95,Nott'm Forest,Tottenham,2,2,D,28,40,33,9,43,30,6,46,47,42
328,04/03/95,Southampton,Coventry,0,0,D,30,47,46,-6,37,28,-14,33,31,40
329,04/03/95,Wimbledon,QPR,1,3,A,27,46,50,-15,32,29,-6,40,39,35
330,05/03/95,Arsenal,West Ham,0,1,A,29,39,32,3,29,30,-12,27,40,35
331,05/03/95,Chelsea,Crystal Palace,0,0,D,29,31,39,-2,30,28,-10,21,36,37
332,06/03/95,Aston Villa,Coventry,0,0,D,31,47,46,0,38,32,-14,33,38,46
333,07/03/95,Wimbledon,Man United,0,1,A,31,22,53,-17,66,30,40,62,39,36
334,08/03/95,Blackburn,Arsenal,3,1,H,31,33,26,38,40,31,2,35,69,64
335,08/03/95,Man City,Chelsea,1,2,A,29,39,45,-7,37,30,-2,37,37,38
336,08/03/95,Newcastle,West Ham,2,0,H,30,39,33,19,32,31,-11,28,57,52
337,08/03/95,Norwich,Sheffield Weds,0,0,D,31,40,34,-6,42,30,0,40,37,28
338,08/03/95,Nott'm Forest,Everton,2,1,H,31,41,35,9,35,31,-9,32,48,44
339,08/03/95,QPR,Leicester,2,0,H,30,56,47,-4,21,28,-23,33,35,43
340,08/03/95,Tottenham,Ipswich,3,0,H,31,69,42,6,23,29,-38,31,44,48
341,11/03/95,Chelsea,Leeds,0,3,A,29,29,40,-1,43,30,6,35,40,39
342,11/03/95,Coventry,Blackburn,1,1,D,32,27,47,-14,72,32,40,67,39,33
343,11/03/95,Leicester,Nott'm Forest,2,4,A,32,36,58,-25,51,31,10,46,21,33
344,11/03/95,Sheffield Weds,Wimbledon,0,1,A,31,54,40,0,39,32,-18,36,43,40
345,11/03/95,West Ham,Norwich,2,2,D,31,34,41,-13,38,31,-6,28,32,28
346,14/03/95,Crystal Palace,Sheffield Weds,2,1,H,33,41,31,-10,43,30,-1,40,31,21
347,14/03/95,Liverpool,Coventry,2,3,A,33,48,23,27,40,29,-14,34,54,50
348,15/03/95,Everton,Man City,1,1,D,31,47,43,-10,37,32,-8,39,35,33
349,15/03/95,Leicester,Leeds,1,3,A,30,29,62,-27,46,32,9,38,21,35
350,15/03/95,Man United,Tottenham,0,0,D,30,42,22,41,47,32,9,51,69,63
351,15/03/95,QPR,Norwich,2,0,H,32,36,47,-2,39,29,-6,30,38,45
352,15/03/95,Southampton,West Ham,1,1,D,32,43,46,-6,33,29,-13,30,32,40
353,18/03/95,Aston Villa,West Ham,0,2,A,33,44,46,0,34,33,-13,31,39,46
354,18/03/95,Blackburn,Chelsea,2,1,H,31,43,28,40,40,33,-4,39,73,68
355,18/03/95,Leeds,Coventry,3,0,H,34,50,30,11,43,31,-13,37,49,41
356,18/03/95,Man City,Sheffield Weds,3,2,H,34,43,48,-8,43,32,-2,41,38,40
357,18/03/95,Nott'm Forest,Southampton,3,0,H,30,47,38,12,33,33,-6,41,54,50
358,18/03/95,QPR,Everton,2,3,A,33,44,47,0,36,30,-10,34,41,47
359,18/03/95,Tottenham,Leicester,1,0,H,33,65,42,9,21,31,-29,36,48,51
360,18/03/95,Wimbledon,Crystal Palace,2,0,H,31,32,54,-17,34,32,-9,23,42,37
361,19/03/95,Liverpool,Man United,2,0,H,33,22,26,26,70,30,41,63,54,52
362,19/03/95,Newcastle,Arsenal,1,0,H,32,36,33,21,40,32,0,36,60,54
363,20/03/95,Norwich,Ipswich,3,0,H,32,72,38,-8,23,33,-41,31,39,30
364,21/03/95,Wimbledon,Man City,2,0,H,33,50,54,-15,41,33,-7,43,45,39
365,22/03/95,Man United,Arsenal,3,0,H,33,37,24,39,40,34,-1,36,70,63
366,22/03/95,Nott'm Forest,Leeds,3,0,H,32,30,38,15,52,34,14,44,57,53
367,22/03/95,QPR,Chelsea,1,0,H,32,45,50,-1,40,31,-5,40,41,49
368,22/03/95,Southampton,Newcastle,3,1,H,33,33,50,-9,63,31,22,55,33,41
369,22/03/95,Tottenham,Liverpool,0,0,D,31,26,42,10,57,32,28,54,51,52
370,01/04/95,Arsenal,Norwich,5,1,H,34,38,40,-4,42,34,-5,33,40,36
371,01/04/95,Chelsea,Newcastle,1,1,D,34,36,46,-6,63,33,20,56,40,40
372,01/04/95,Coventry,QPR,0,1,A,32,50,53,-16,44,35,0,50,43,37
373,01/04/95,Crystal Palace,Man City,2,1,H,34,52,34,-11,41,32,-9,43,34,23
374,01/04/95,Everton,Blackburn,1,2,A,34,29,46,-9,76,34,41,70,39,37
375,01/04/95,Ipswich,Aston Villa,0,1,A,34,48,75,-44,39,33,-2,46,23,31
376,01/04/95,Leicester,Wimbledon,3,4,A,34,54,66,-30,48,34,-13,41,21,36
377,01/04/95,Sheffield Weds,Nott'm Forest,1,7,A,35,38,46,-3,60,35,18,56,43,43
378,02/04/95,Man United,Leeds,0,0,D,33,33,24,42,52,35,11,44,73,66
379,02/04/95,Southampton,Tottenham,4,3,H,33,42,51,-7,52,32,10,52,36,44
380,04/04/95,Crystal Palace,Aston Villa,0,0,D,35,48,35,-10,42,33,-1,47,37,25
381,04/04/95,QPR,Blackburn,0,1,A,35,30,50,1,79,33,42,72,47,51
382,05/04/95,Leeds,Ipswich,4,0,H,34,76,33,11,23,34,-45,31,53,44
383,05/04/95,Leicester,Norwich,1,0,H,35,43,70,-31,42,35,-9,34,21,39
384,05/04/95,Liverpool,Southampton,3,1,H,33,54,26,28,39,32,-6,48,58,54
385,08/04/95,Newcastle,Norwich,3,0,H,36,44,37,20,42,35,-10,34,64,57
386,08/04/95,Nott'm Forest,West Ham,1,1,D,34,44,39,24,37,36,-11,33,63,63
387,08/04/95,QPR,Arsenal,3,1,H,35,41,51,0,43,34,0,41,47,51
388,08/04/95,Sheffield Weds,Leicester,1,0,H,36,70,53,-9,24,36,-30,40,43,44
389,09/04/95,Liverpool,Leeds,0,1,A,35,33,27,30,56,33,15,48,61,57
390,10/04/95,Wimbledon,Chelsea,1,1,D,34,47,57,-12,41,35,-6,41,51,45
391,11/04/95,Ipswich,QPR,0,1,A,35,52,80,-49,50,35,2,54,23,31
392,11/04/95,Tottenham,Man City,2,1,H,35,54,46,9,41,34,-10,44,52,55
393,12/04/95,Arsenal,Liverpool,0,1,A,34,28,44,-2,61,36,29,57,43,42
394,12/04/95,Chelsea,Southampton,0,2,A,34,57,48,-6,39,35,-8,49,42,42
395,12/04/95,Norwich,Nott'm Forest,0,1,A,37,40,47,-13,64,37,24,64,42,34
396,13/04/95,West Ham,Wimbledon,3,0,H,36,58,45,-11,52,35,-12,46,38,34
397,14/04/95,Crystal Palace,Tottenham,1,1,D,35,47,35,-10,55,34,10,57,38,25
398,14/04/95,Everton,Newcastle,2,0,H,36,37,48,-10,67,35,23,60,39,38
399,14/04/95,Man City,Liverpool,2,1,H,35,28,56,-11,64,36,30,58,41,45
400,15/04/95,Arsenal,Ipswich,4,1,H,36,81,45,-3,23,37,-50,31,43,42
401,15/04/95,Chelsea,Aston Villa,1,0,H,36,48,50,-8,43,36,-1,47,42,42
402,15/04/95,Coventry,Sheffield Weds,2,0,H,37,53,54,-17,46,36,-8,45,43,37
403,15/04/95,Leeds,Blackburn,1,1,D,36,30,33,16,82,36,43,73,59,49
404,15/04/95,Leicester,Man United,0,4,A,36,24,71,-31,74,37,42,66,24,40
405,15/04/95,Southampton,QPR,2,1,H,36,52,57,-6,53,35,3,55,42,51
406,17/04/95,Aston Villa,Arsenal,0,4,A,38,46,49,-2,46,37,0,46,43,47
407,17/04/95,Blackburn,Man City,2,3,A,37,57,31,43,44,37,-10,47,83,74
408,17/04/95,Ipswich,West Ham,1,1,D,36,45,85,-53,41,37,-8,37,23,32
409,17/04/95,Liverpool,Leicester,2,0,H,38,75,30,29,24,36,-35,40,64,59
410,17/04/95,Man United,Chelsea,0,0,D,37,50,24,46,45,37,-7,43,77,70
411,17/04/95,Newcastle,Leeds,1,2,A,37,34,39,21,60,37,16,50,67,60
412,17/04/95,Nott'm Forest,Coventry,2,0,H,37,54,40,25,46,38,-15,39,67,65
413,17/04/95,QPR,Crystal Palace,0,1,A,35,36,54,2,39,37,-10,26,53,56
414,17/04/95,Sheffield Weds,Everton,0,0,D,36,48,55,-10,42,38,-8,40,46,45
415,17/04/95,Tottenham,Norwich,1,0,H,38,48,48,10,42,36,-14,34,56,58
416,17/04/95,Wimbledon,Southampton,0,2,A,36,58,61,-15,45,37,-5,53,52,46
417,19/04/95,Blackburn,Crystal Palace,2,1,H,36,36,34,42,42,38,-9,27,83,76
418,29/04/95,Arsenal,Tottenham,1,1,D,37,48,46,4,59,39,11,59,49,50
419,29/04/95,Chelsea,QPR,1,0,H,38,55,50,-7,53,38,1,56,46,43
420,29/04/95,Crystal Palace,Nott'm Forest,1,2,A,39,40,38,-10,70,37,27,67,42,28
421,29/04/95,Everton,Wimbledon,0,0,D,38,63,48,-8,52,37,-17,46,43,40
422,29/04/95,Leeds,Aston Villa,1,0,H,38,53,35,17,43,38,-6,47,63,52
423,29/04/95,Leicester,Ipswich,2,0,H,38,86,77,-37,24,39,-53,33,24,40
424,29/04/95,Man City,Newcastle,0,0,D,38,41,59,-9,67,38,20,61,47,50
425,29/04/95,Norwich,Liverpool,1,2,A,37,30,49,-15,67,39,31,61,42,34
426,29/04/95,Southampton,Sheffield Weds,0,0,D,39,55,58,-3,47,37,-10,45,48,55
427,30/04/95,West Ham,Blackburn,2,0,H,39,35,46,-8,86,37,43,78,42,38
428,01/05/95,Coventry,Man United,2,3,A,38,24,56,-17,78,38,46,70,46,39
429,02/05/95,Wimbledon,Liverpool,0,0,D,38,31,63,-17,70,39,32,63,53,46
430,03/05/95,Aston Villa,Man City,1,1,D,39,59,54,-7,48,39,-9,50,43,47
431,03/05/95,Everton,Chelsea,3,3,D,39,50,48,-8,49,38,-6,44,44,40
432,03/05/95,Newcastle,Tottenham,3,3,D,38,49,41,20,60,39,11,60,68,61
433,03/05/95,Southampton,Crystal Palace,3,1,H,38,40,58,-3,42,38,-11,29,49,55
434,03/05/95,West Ham,QPR,0,0,D,39,56,46,-6,53,38,0,56,45,40
435,04/05/95,Arsenal,Wimbledon,0,0,D,40,63,47,4,54,40,-17,46,50,51
436,06/05/95,Aston Villa,Liverpool,2,0,H,39,31,55,-7,71,40,32,63,44,48
437,06/05/95,Crystal Palace,West Ham,1,0,H,39,46,43,-13,46,39,-6,40,42,30
438,06/05/95,Everton,Southampton,0,0,D,39,59,51,-8,52,39,-1,58,45,43
439,06/05/95,Ipswich,Coventry,2,0,H,39,59,88,-55,46,39,-18,41,24,33
440,06/05/95,Leeds,Norwich,2,1,H,40,51,35,18,42,39,-16,35,66,53
441,06/05/95,Leicester,Chelsea,1,1,D,40,53,77,-35,50,40,-6,47,27,42
442,06/05/95,Nott'm Forest,Man City,1,0,H,40,60,41,28,49,40,-9,51,73,69
443,06/05/95,QPR,Tottenham,2,1,H,39,52,56,0,61,40,11,63,54,56
444,07/05/95,Man United,Sheffield Weds,1,0,H,40,55,26,47,48,39,-10,45,81,73
445,08/05/95,Blackburn,Newcastle,1,0,H,40,44,37,41,69,40,20,64,86,78
446,09/05/95,Ipswich,Everton,0,1,A,40,51,88,-53,46,40,-8,43,27,35
447,09/05/95,Leeds,Crystal Palace,3,1,H,40,43,36,19,45,40,-12,31,69,55
448,09/05/95,Tottenham,Coventry,1,3,A,40,61,54,10,46,40,-20,41,61,64
449,10/05/95,Man United,Southampton,2,1,H,40,59,26,48,53,40,-1,58,84,74
450,10/05/95,West Ham,Liverpool,3,0,H,40,33,47,-7,71,40,30,63,46,40
451,13/05/95,Wimbledon,Nott'm Forest,2,2,D,41,41,63,-17,76,41,29,70,55,46
452,14/05/95,Chelsea,Arsenal,2,1,H,41,47,54,-6,51,41,4,51,51,48
453,14/05/95,Coventry,Everton,0,0,D,41,51,62,-18,49,41,-7,44,49,44
454,14/05/95,Liverpool,Blackburn,2,1,H,41,37,36,27,89,41,42,79,71,63
455,14/05/95,Man City,QPR,2,3,A,41,57,61,-10,57,41,1,58,49,51
456,14/05/95,Newcastle,Crystal Palace,3,2,H,41,46,45,19,45,41,-14,32,69,64
457,14/05/95,Norwich,Aston Villa,1,1,D,41,55,53,-17,47,41,-5,50,42,36
458,14/05/95,Sheffield Weds,Ipswich,4,1,H,41,89,56,-11,27,41,-54,35,48,45
459,14/05/95,Southampton,Leicester,2,2,D,41,78,61,-2,28,41,-35,43,53,59
460,14/05/95,Tottenham,Leeds,1,1,D,41,37,57,8,72,41,21,58,61,65
461,14/05/95,West Ham,Man United,1,1,D,41,27,47,-4,87,41,49,76,49,43
