MatchID,Date,HomeTeam,AwayTeam,FTHG,FTAG,FTR,AT_match_played,AT_goal_against,HT_goal_against,HT_goal_differnece,AT_current_standing,HT_match_played,AT_goal_differnece,AT_goal_for,HT_current_standing,HT_goal_for
0,19/08/95,Aston Villa,Man United,3,1,H,0,0,0,0,0,0,0,0,0,0
1,19/08/95,Blackburn,QPR,1,0,H,0,0,0,0,0,0,0,0,0,0
2,19/08/95,Chelsea,Everton,0,0,D,0,0,0,0,0,0,0,0,0,0
3,19/08/95,Liverpool,Sheffield Weds,1,0,H,0,0,0,0,0,0,0,0,0,0
4,19/08/95,Man City,Tottenham,1,1,D,0,0,0,0,0,0,0,0,0,0
5,19/08/95,Newcastle,Coventry,3,0,H,0,0,0,0,0,0,0,0,0,0
6,19/08/95,Southampton,Nott'm Forest,3,4,A,0,0,0,0,0,0,0,0,0,0
7,19/08/95,West Ham,Leeds,1,2,A,0,0,0,0,0,0,0,0,0,0
8,19/08/95,Wimbledon,Bolton,3,2,H,0,0,0,0,0,0,0,0,0,0
9,20/08/95,Arsenal,Middlesbrough,1,1,D,0,0,0,0,0,0,0,0,0,0
10,21/08/95,Leeds,Liverpool,1,0,H,1,0,1,1,3,1,1,1,3,2
11,22/08/95,Bolton,Newcastle,1,3,A,1,0,3,-1,3,1,3,3,0,2
12,23/08/95,Coventry,Man City,2,1,H,1,1,3,-3,1,1,0,1,0,0
13,23/08/95,Everton,Arsenal,0,2,A,1,1,0,0,1,1,0,1,1,0
14,23/08/95,Man United,West Ham,2,1,H,1,2,3,-2,0,1,-1,1,0,1
15,23/08/95,Nott'm Forest,Chelsea,0,0,D,1,0,3,1,1,1,0,0,3,4
16,23/08/95,QPR,Wimbledon,0,3,A,1,2,1,-1,3,1,1,3,0,0
17,23/08/95,Sheffield Weds,Blackburn,2,1,H,1,0,1,-1,3,1,1,1,0,0
18,23/08/95,Tottenham,Aston Villa,0,1,A,1,1,1,0,3,1,2,3,1,1
19,26/08/95,Bolton,Blackburn,2,1,H,2,2,6,-3,3,2,0,2,0,3
20,26/08/95,Coventry,Arsenal,0,0,D,2,1,4,-2,4,2,2,3,3,2
21,26/08/95,Everton,Southampton,2,0,H,1,4,2,-2,0,2,-1,3,1,0
22,26/08/95,Leeds,Aston Villa,2,0,H,2,1,1,2,6,2,3,4,6,3
23,26/08/95,Man United,Wimbledon,3,1,H,2,2,4,-1,6,2,4,6,3,3
24,26/08/95,Middlesbrough,Chelsea,2,0,H,2,0,1,0,2,1,0,0,1,1
25,26/08/95,Nott'm Forest,West Ham,1,1,D,2,4,3,1,0,2,-2,2,4,4
26,26/08/95,QPR,Man City,1,0,H,2,3,4,-4,1,2,-1,2,0,0
27,26/08/95,Tottenham,Liverpool,1,3,A,2,1,2,-1,3,2,0,1,1,1
28,27/08/95,Sheffield Weds,Newcastle,0,2,A,2,1,2,0,6,2,5,6,3,2
29,28/08/95,Blackburn,Man United,1,2,A,3,5,4,-1,6,3,1,6,3,3
30,29/08/95,Arsenal,Nott'm Forest,1,1,D,3,4,1,2,5,3,1,5,5,3
31,30/08/95,Aston Villa,Bolton,1,0,H,3,7,3,1,3,3,-2,5,6,4
32,30/08/95,Chelsea,Coventry,2,2,D,3,4,2,-2,4,3,-2,2,2,0
33,30/08/95,Liverpool,QPR,1,0,H,3,4,2,2,3,3,-3,1,6,4
34,30/08/95,Man City,Everton,0,2,A,3,2,4,-2,4,3,0,2,1,2
35,30/08/95,Newcastle,Middlesbrough,1,0,H,2,1,1,7,4,3,2,3,9,8
36,30/08/95,Southampton,Leeds,1,1,D,3,1,6,-3,9,2,4,5,0,3
37,30/08/95,West Ham,Tottenham,1,1,D,3,5,5,-2,1,3,-3,2,1,3
38,30/08/95,Wimbledon,Sheffield Weds,2,2,D,3,4,5,2,3,3,-2,2,6,7
39,09/09/95,Blackburn,Aston Villa,1,1,D,4,3,6,-2,9,4,2,5,3,4
40,09/09/95,Bolton,Middlesbrough,1,1,D,3,2,8,-3,4,4,1,3,3,5
41,09/09/95,Coventry,Nott'm Forest,1,1,D,4,5,6,-2,6,4,1,6,5,4
42,09/09/95,Everton,Man United,2,3,A,4,6,2,2,9,4,2,8,7,4
43,09/09/95,QPR,Sheffield Weds,0,3,A,4,6,5,-4,4,4,-2,4,3,1
44,09/09/95,Southampton,Newcastle,1,0,H,4,1,7,-3,12,3,8,9,1,4
45,09/09/95,Tottenham,Leeds,2,1,H,4,2,6,-3,10,4,4,6,2,3
46,09/09/95,Wimbledon,Liverpool,1,0,H,4,2,7,2,9,4,3,5,7,9
47,10/09/95,Man City,Arsenal,0,1,A,4,2,6,-4,6,4,2,4,1,2
48,11/09/95,West Ham,Chelsea,1,3,A,4,4,6,-2,3,4,-2,2,2,4
49,12/09/95,Middlesbrough,Southampton,0,0,D,4,7,3,1,4,4,-2,5,5,4
50,16/09/95,Arsenal,West Ham,1,0,H,5,9,2,3,2,5,-4,5,9,5
51,16/09/95,Aston Villa,Wimbledon,2,0,H,5,7,4,2,10,5,3,10,10,6
52,16/09/95,Chelsea,Southampton,3,0,H,5,7,5,0,5,5,-2,5,6,5
53,16/09/95,Leeds,QPR,1,3,A,5,8,4,3,3,5,-7,1,10,7
54,16/09/95,Liverpool,Blackburn,3,0,H,5,7,3,2,4,5,-2,5,9,5
55,16/09/95,Man United,Bolton,3,0,H,5,9,8,3,4,5,-3,6,12,11
56,16/09/95,Middlesbrough,Coventry,2,1,H,5,7,3,1,6,5,-2,5,6,4
57,16/09/95,Newcastle,Man City,3,1,H,5,7,2,7,1,5,-5,2,12,9
58,16/09/95,Sheffield Weds,Tottenham,1,3,A,5,7,6,1,5,5,-2,5,7,7
59,17/09/95,Nott'm Forest,Everton,3,2,H,5,5,6,1,7,5,1,6,7,7
60,23/09/95,Arsenal,Southampton,4,2,H,6,10,2,4,5,6,-5,5,12,6
61,23/09/95,Aston Villa,Nott'm Forest,1,1,D,6,8,4,4,10,6,2,10,13,8
62,23/09/95,Blackburn,Coventry,5,1,H,6,9,10,-5,6,6,-3,6,4,5
63,23/09/95,Liverpool,Bolton,5,2,H,6,12,3,5,4,6,-6,6,12,8
64,23/09/95,Man City,Middlesbrough,0,1,A,6,4,10,-7,9,6,2,6,1,3
65,23/09/95,Sheffield Weds,Man United,0,0,D,6,8,9,-1,15,6,6,14,7,8
66,23/09/95,West Ham,Everton,2,1,H,6,8,10,-5,7,6,0,8,2,5
67,23/09/95,Wimbledon,Leeds,2,4,A,6,7,9,1,10,6,1,8,10,10
68,24/09/95,Newcastle,Chelsea,2,0,H,6,5,3,9,9,6,3,8,15,12
69,25/09/95,QPR,Tottenham,2,3,A,6,8,9,-5,8,6,0,8,6,4
70,30/09/95,Bolton,QPR,0,1,A,7,12,17,-9,6,7,-6,6,4,8
71,30/09/95,Chelsea,Arsenal,1,0,H,7,4,7,1,15,7,6,10,9,8
72,30/09/95,Coventry,Aston Villa,0,3,A,7,5,14,-7,14,7,4,9,6,7
73,30/09/95,Leeds,Sheffield Weds,2,0,H,7,9,9,3,8,7,-1,8,13,12
74,30/09/95,Middlesbrough,Blackburn,2,0,H,7,11,4,3,7,7,-1,10,12,7
75,30/09/95,Nott'm Forest,Man City,3,0,H,7,11,9,2,1,7,-8,3,11,11
76,30/09/95,Tottenham,Wimbledon,3,1,H,7,13,10,1,10,7,-1,12,11,11
77,01/10/95,Everton,Newcastle,1,3,A,7,3,10,-1,18,7,11,14,7,9
78,01/10/95,Man United,Liverpool,2,2,D,7,5,8,6,15,7,8,13,16,14
79,02/10/95,Southampton,West Ham,0,0,D,7,11,14,-7,5,7,-4,7,5,7
80,14/10/95,Aston Villa,Chelsea,0,1,A,8,7,5,7,12,8,2,9,17,12
81,14/10/95,Blackburn,Southampton,2,1,H,8,14,13,-3,6,8,-7,7,7,10
82,14/10/95,Bolton,Everton,1,1,D,8,13,18,-10,7,8,-3,10,4,8
83,14/10/95,Leeds,Arsenal,0,3,A,8,5,9,5,15,8,5,10,16,14
84,14/10/95,Liverpool,Coventry,0,0,D,8,17,7,8,6,8,-10,7,16,15
85,14/10/95,Man United,Man City,1,0,H,8,14,10,6,1,8,-11,3,17,16
86,14/10/95,QPR,Newcastle,2,3,A,8,4,12,-5,21,8,13,17,9,7
87,14/10/95,Tottenham,Nott'm Forest,0,1,A,8,9,11,3,14,8,5,14,14,14
88,15/10/95,Sheffield Weds,Middlesbrough,0,1,A,8,4,11,-3,15,8,5,9,8,8
89,16/10/95,Wimbledon,West Ham,0,1,A,8,11,16,-3,6,8,-4,7,10,13
90,21/10/95,Arsenal,Aston Villa,2,0,H,9,6,5,8,17,9,6,12,18,13
91,21/10/95,Chelsea,Man United,1,4,A,9,10,7,3,20,9,7,17,15,10
92,21/10/95,Coventry,Sheffield Weds,0,1,A,9,12,17,-10,8,9,-4,8,7,7
93,21/10/95,Man City,Leeds,0,0,D,9,12,15,-12,16,9,2,14,1,3
94,21/10/95,Middlesbrough,QPR,1,0,H,9,15,4,6,9,9,-6,9,18,10
95,21/10/95,Newcastle,Wimbledon,6,1,H,9,17,6,14,10,9,-4,13,24,20
96,21/10/95,Nott'm Forest,Bolton,3,2,H,9,19,9,6,5,9,-10,9,17,15
97,21/10/95,West Ham,Blackburn,1,1,D,9,14,11,-3,10,9,-2,12,9,8
98,22/10/95,Everton,Tottenham,1,1,D,9,12,14,-3,14,9,2,14,8,11
99,22/10/95,Southampton,Liverpool,1,3,A,9,7,16,-8,17,9,8,15,6,8
100,28/10/95,Aston Villa,Everton,1,0,H,10,15,8,4,9,10,-3,12,17,12
101,28/10/95,Blackburn,Chelsea,3,0,H,10,11,15,-2,15,10,0,11,11,13
102,28/10/95,Leeds,Coventry,3,1,H,10,18,12,2,7,10,-11,7,17,14
103,28/10/95,Liverpool,Man City,6,0,H,10,15,8,10,2,10,-12,3,20,18
104,28/10/95,Man United,Middlesbrough,2,0,H,10,4,11,10,21,10,7,11,23,21
105,28/10/95,QPR,Nott'm Forest,1,1,D,10,11,16,-7,20,10,7,18,9,9
106,28/10/95,Sheffield Weds,West Ham,0,1,A,10,12,12,-3,10,10,-3,9,11,9
107,28/10/95,Wimbledon,Southampton,1,2,A,10,19,23,-9,6,10,-10,9,10,14
108,29/10/95,Tottenham,Newcastle,1,1,D,10,7,13,2,27,10,19,26,15,15
109,30/10/95,Bolton,Arsenal,1,0,H,10,5,22,-11,21,10,10,15,5,11
110,04/11/95,Arsenal,Man United,1,0,H,11,11,6,9,26,11,12,23,21,15
111,04/11/95,Chelsea,Sheffield Weds,0,0,D,11,13,14,-3,11,11,-4,9,15,11
112,04/11/95,Coventry,Tottenham,2,3,A,11,14,21,-13,16,11,2,16,7,8
113,04/11/95,Man City,Bolton,1,0,H,11,22,21,-18,8,11,-10,12,2,3
114,04/11/95,Middlesbrough,Leeds,1,1,D,11,13,6,5,20,11,4,17,21,11
115,04/11/95,Newcastle,Liverpool,2,1,H,11,8,8,19,23,11,16,24,28,27
116,04/11/95,Southampton,QPR,2,0,H,11,17,20,-9,10,11,-7,10,9,11
117,04/11/95,West Ham,Aston Villa,1,4,A,11,8,12,-2,20,11,5,13,13,10
118,05/11/95,Everton,Blackburn,1,0,H,11,15,16,-4,14,11,1,16,9,12
119,06/11/95,Nott'm Forest,Wimbledon,4,1,H,11,25,12,7,10,11,-10,15,21,19
120,08/11/95,Newcastle,Blackburn,1,0,H,12,16,9,20,14,12,0,16,31,29
121,18/11/95,Aston Villa,Newcastle,1,1,D,13,9,9,8,34,12,21,30,23,17
122,18/11/95,Blackburn,Nott'm Forest,7,0,H,12,13,17,-1,24,13,10,23,14,16
123,18/11/95,Bolton,West Ham,0,3,A,12,16,23,-11,13,12,-5,11,8,12
124,18/11/95,Leeds,Chelsea,1,0,H,12,14,14,4,16,12,-3,11,21,18
125,18/11/95,Liverpool,Everton,1,2,A,12,16,10,15,12,12,-3,13,23,25
126,18/11/95,Man United,Southampton,4,1,H,12,20,12,11,12,12,-7,13,26,23
127,18/11/95,Sheffield Weds,Man City,1,1,D,12,21,13,-4,5,12,-17,4,12,9
128,18/11/95,Tottenham,Arsenal,2,1,H,12,6,16,3,24,12,10,16,19,19
129,18/11/95,Wimbledon,Middlesbrough,0,0,D,12,7,29,-13,22,12,5,12,10,16
130,19/11/95,QPR,Coventry,1,1,D,12,24,19,-9,7,12,-14,10,10,10
131,20/11/95,Southampton,Aston Villa,0,1,A,13,10,24,-10,24,13,8,18,12,14
132,21/11/95,Arsenal,Sheffield Weds,4,2,H,13,14,8,9,13,13,-4,10,24,17
133,21/11/95,Middlesbrough,Tottenham,0,1,A,13,17,7,5,22,13,4,21,23,12
134,22/11/95,Chelsea,Bolton,3,2,H,13,26,15,-4,8,13,-14,12,16,11
135,22/11/95,Coventry,Man United,0,4,A,13,13,25,-14,29,13,14,27,8,11
136,22/11/95,Everton,QPR,2,0,H,13,20,17,-2,11,13,-9,11,15,15
137,22/11/95,Man City,Wimbledon,1,0,H,13,29,22,-17,11,13,-13,16,6,5
138,22/11/95,West Ham,Liverpool,0,0,D,13,12,16,-2,23,13,14,26,16,14
139,25/11/95,Chelsea,Tottenham,0,0,D,14,17,17,-3,25,14,5,22,19,14
140,25/11/95,Coventry,Wimbledon,3,3,D,14,30,29,-18,11,14,-14,16,8,11
141,25/11/95,Everton,Sheffield Weds,2,2,D,14,18,17,0,13,14,-6,12,18,17
142,25/11/95,Man City,Aston Villa,1,0,H,14,10,22,-16,27,14,9,19,9,6
143,25/11/95,Middlesbrough,Liverpool,2,1,H,14,12,8,4,24,14,14,26,23,12
144,25/11/95,Newcastle,Leeds,2,1,H,13,14,10,21,24,14,5,19,35,31
145,25/11/95,Southampton,Bolton,1,0,H,14,29,25,-11,8,14,-15,14,12,14
146,25/11/95,West Ham,QPR,1,0,H,14,22,16,-2,11,14,-11,11,17,14
147,26/11/95,Arsenal,Blackburn,0,0,D,14,17,10,11,17,14,6,23,27,21
148,27/11/95,Nott'm Forest,Man United,1,1,D,14,13,20,3,32,13,18,31,24,23
149,02/12/95,Aston Villa,Arsenal,1,1,D,15,10,11,8,28,15,11,21,27,19
150,02/12/95,Blackburn,West Ham,4,2,H,15,16,17,6,20,15,-1,15,18,23
151,02/12/95,Bolton,Nott'm Forest,1,1,D,14,21,30,-16,25,15,3,24,8,14
152,02/12/95,Leeds,Man City,0,1,A,15,22,16,4,12,14,-15,7,24,20
153,02/12/95,Liverpool,Southampton,1,1,D,15,25,14,13,15,15,-10,15,24,27
154,02/12/95,Man United,Chelsea,1,1,D,15,17,14,18,20,15,-3,14,33,32
155,02/12/95,QPR,Middlesbrough,1,1,D,15,9,23,-12,26,15,5,14,11,11
156,02/12/95,Tottenham,Everton,0,0,D,15,19,17,5,19,15,0,19,26,22
157,03/12/95,Wimbledon,Newcastle,3,3,D,15,11,33,-14,38,15,22,33,12,19
158,04/12/95,Sheffield Weds,Coventry,4,3,H,15,32,20,-6,9,15,-18,14,14,14
159,09/12/95,Bolton,Liverpool,0,1,A,16,15,31,-16,25,16,13,28,9,15
160,09/12/95,Chelsea,Newcastle,1,0,H,16,14,18,-3,39,16,22,36,21,15
161,09/12/95,Coventry,Blackburn,5,0,H,16,19,36,-19,21,16,8,27,9,17
162,09/12/95,Leeds,Wimbledon,1,1,D,16,36,17,3,13,15,-14,22,24,20
163,09/12/95,Man United,Sheffield Weds,2,2,D,16,23,15,18,17,16,-5,18,34,33
164,09/12/95,Middlesbrough,Man City,4,1,H,16,22,10,5,15,16,-14,8,27,15
165,09/12/95,Southampton,Arsenal,0,0,D,16,11,26,-10,29,16,11,22,16,16
166,09/12/95,Tottenham,QPR,1,0,H,16,24,17,5,12,16,-12,12,27,22
167,10/12/95,Nott'm Forest,Aston Villa,1,1,D,16,12,22,3,28,15,8,20,26,25
168,11/12/95,Everton,West Ham,3,0,H,16,20,19,0,20,16,-3,17,20,19
169,16/12/95,Arsenal,Chelsea,1,1,D,17,18,11,11,24,17,-2,16,30,22
170,16/12/95,Aston Villa,Coventry,4,1,H,17,36,13,8,12,17,-14,22,29,21
171,16/12/95,Blackburn,Middlesbrough,1,0,H,17,11,24,3,30,17,8,19,21,27
172,16/12/95,Newcastle,Everton,1,0,H,17,19,15,21,23,17,3,22,39,36
173,16/12/95,QPR,Bolton,2,1,H,17,32,25,-13,9,17,-17,15,12,12
174,16/12/95,Sheffield Weds,Leeds,6,2,H,16,18,25,-5,25,17,3,21,18,20
175,16/12/95,West Ham,Southampton,2,1,H,17,26,23,-6,17,17,-10,16,20,17
176,16/12/95,Wimbledon,Tottenham,0,1,A,17,17,37,-14,30,17,6,23,14,23
177,17/12/95,Liverpool,Man United,2,0,H,17,17,15,14,35,17,18,35,28,29
178,18/12/95,Man City,Nott'm Forest,1,1,D,16,23,26,-17,27,17,3,26,15,9
179,23/12/95,Coventry,Everton,2,1,H,18,20,40,-17,23,18,2,22,12,23
180,23/12/95,Liverpool,Arsenal,3,1,H,18,12,15,16,31,18,11,23,31,31
181,23/12/95,Man City,Chelsea,0,1,A,18,19,27,-17,25,18,-2,17,16,10
182,23/12/95,Middlesbrough,West Ham,4,2,H,18,24,12,7,23,18,-5,19,30,19
183,23/12/95,Newcastle,Nott'm Forest,3,1,H,17,24,15,22,28,18,3,27,42,37
184,23/12/95,QPR,Aston Villa,1,0,H,18,14,26,-12,32,18,11,25,15,14
185,23/12/95,Sheffield Weds,Southampton,2,2,D,18,28,27,-1,17,18,-11,17,21,26
186,23/12/95,Tottenham,Bolton,2,2,D,18,34,17,7,9,18,-18,16,33,24
187,23/12/95,Wimbledon,Blackburn,1,1,D,18,24,38,-15,24,18,4,28,14,23
188,24/12/95,Leeds,Man United,3,1,H,18,19,24,-1,35,17,16,35,25,23
189,26/12/95,Arsenal,QPR,3,0,H,19,26,15,9,18,19,-11,15,31,24
190,26/12/95,Blackburn,Man City,2,0,H,19,28,25,4,16,19,-18,10,25,29
191,26/12/95,Chelsea,Wimbledon,1,2,A,19,39,19,-1,15,19,-15,24,28,18
192,26/12/95,Everton,Middlesbrough,4,0,H,19,14,22,1,33,19,9,23,23,23
193,26/12/95,Nott'm Forest,Sheffield Weds,1,0,H,19,29,27,1,22,18,-1,28,28,28
194,26/12/95,Southampton,Tottenham,0,0,D,19,19,30,-11,34,19,7,26,18,19
195,27/12/95,Bolton,Leeds,0,2,A,18,25,36,-18,28,19,1,26,10,18
196,27/12/95,Man United,Newcastle,2,0,H,19,16,22,14,45,19,24,40,35,36
197,30/12/95,Arsenal,Wimbledon,1,3,A,20,40,15,12,18,20,-14,26,34,27
198,30/12/95,Blackburn,Tottenham,2,1,H,20,19,25,6,35,20,7,26,28,31
199,30/12/95,Bolton,Coventry,1,2,A,19,41,38,-20,15,20,-16,25,10,18
200,30/12/95,Chelsea,Liverpool,2,2,D,19,16,21,-2,34,20,18,34,28,19
201,30/12/95,Everton,Leeds,2,0,H,19,25,22,5,31,20,3,28,26,27
202,30/12/95,Man United,QPR,2,1,H,20,29,22,16,18,20,-14,15,38,38
203,30/12/95,Nott'm Forest,Middlesbrough,1,0,H,20,18,27,2,33,19,5,23,31,29
204,01/01/96,Coventry,Southampton,1,1,D,20,30,42,-15,19,20,-11,19,18,27
205,01/01/96,Leeds,Blackburn,0,0,D,21,26,27,1,31,20,7,33,31,28
206,01/01/96,Liverpool,Nott'm Forest,4,2,H,20,27,18,18,34,20,3,30,35,36
207,01/01/96,Man City,West Ham,2,1,H,19,28,30,-20,23,20,-7,21,16,10
208,01/01/96,Middlesbrough,Aston Villa,0,2,A,19,15,19,4,32,21,10,25,33,23
209,01/01/96,Sheffield Weds,Bolton,4,2,H,21,40,30,-2,10,20,-21,19,22,28
210,01/01/96,Tottenham,Man United,4,1,H,21,23,21,6,41,21,17,40,35,27
211,01/01/96,Wimbledon,Everton,2,3,A,21,22,41,-12,29,21,7,29,21,29
212,02/01/96,Newcastle,Arsenal,2,0,H,21,18,18,22,34,20,10,28,45,40
213,02/01/96,QPR,Chelsea,1,2,A,21,23,31,-15,29,21,-2,21,18,16
214,13/01/96,Bolton,Wimbledon,1,0,H,22,44,44,-23,21,22,-13,31,10,21
215,13/01/96,Everton,Chelsea,1,1,D,22,24,24,8,32,22,-1,23,32,32
216,13/01/96,Leeds,West Ham,2,0,H,20,30,27,1,23,21,-8,22,32,28
217,13/01/96,Man United,Aston Villa,0,0,D,20,15,27,14,35,22,12,27,41,41
218,13/01/96,Middlesbrough,Arsenal,2,3,A,22,20,21,2,34,22,8,28,33,23
219,13/01/96,Nott'm Forest,Southampton,1,0,H,21,31,31,1,20,21,-11,20,34,32
220,13/01/96,QPR,Blackburn,0,1,A,22,26,33,-16,32,22,7,33,18,17
221,13/01/96,Sheffield Weds,Liverpool,1,1,D,21,20,32,0,38,21,20,40,25,32
222,13/01/96,Tottenham,Man City,1,0,H,21,31,22,9,19,22,-19,12,38,31
223,14/01/96,Coventry,Newcastle,0,1,A,21,18,43,-15,48,21,24,42,19,28
224,20/01/96,Arsenal,Everton,1,2,A,23,25,22,9,33,23,8,33,37,31
225,20/01/96,Blackburn,Sheffield Weds,3,0,H,22,33,26,8,26,23,0,33,35,34
226,20/01/96,Chelsea,Nott'm Forest,1,0,H,22,31,25,-1,37,23,2,33,33,24
227,20/01/96,Liverpool,Leeds,5,0,H,22,27,21,20,35,22,3,30,39,41
228,20/01/96,Man City,Coventry,1,1,D,22,44,32,-20,19,22,-16,28,19,12
229,20/01/96,Newcastle,Bolton,2,1,H,23,44,18,25,13,22,-22,22,51,43
230,20/01/96,Southampton,Middlesbrough,2,1,H,23,24,32,-12,33,22,1,25,20,20
231,20/01/96,Wimbledon,QPR,2,1,H,23,34,45,-14,18,23,-17,17,21,31
232,21/01/96,Aston Villa,Tottenham,2,1,H,23,22,15,12,41,21,10,32,36,27
233,23/01/96,West Ham,Man United,0,1,A,23,27,32,-10,42,21,14,41,23,22
234,31/01/96,Aston Villa,Liverpool,0,2,A,23,21,16,13,42,22,25,46,39,29
235,31/01/96,Nott'm Forest,Leeds,2,1,H,23,32,32,1,35,23,-2,30,37,33
236,31/01/96,Southampton,Man City,1,1,D,23,33,33,-11,20,23,-20,13,23,22
237,31/01/96,West Ham,Coventry,3,2,H,23,45,33,-11,20,22,-16,29,23,22
238,03/02/96,Arsenal,Coventry,1,1,D,24,48,24,8,20,24,-17,31,37,32
239,03/02/96,Aston Villa,Leeds,3,0,H,24,34,18,11,35,23,-3,31,39,29
240,03/02/96,Blackburn,Bolton,3,1,H,24,46,26,11,13,24,-23,23,38,37
241,03/02/96,Liverpool,Tottenham,0,0,D,24,24,21,27,41,24,9,33,45,48
242,03/02/96,Man City,QPR,2,0,H,24,36,34,-20,18,24,-18,18,21,14
243,03/02/96,Newcastle,Sheffield Weds,2,0,H,23,36,19,26,26,23,-3,33,54,45
244,03/02/96,Southampton,Everton,2,2,D,24,26,34,-11,36,24,9,35,24,23
245,03/02/96,West Ham,Nott'm Forest,1,0,H,24,33,35,-10,40,23,2,35,26,25
246,03/02/96,Wimbledon,Man United,2,4,A,24,27,46,-13,45,24,15,42,24,33
247,04/02/96,Chelsea,Middlesbrough,5,0,H,24,26,25,0,33,24,0,26,36,25
248,10/02/96,Bolton,Aston Villa,0,2,A,24,18,49,-25,42,25,14,32,13,24
249,10/02/96,Coventry,Chelsea,1,0,H,25,25,49,-17,39,25,5,30,21,32
250,10/02/96,Everton,Man City,2,0,H,25,34,28,9,24,25,-18,16,37,37
251,10/02/96,Man United,Blackburn,1,0,H,25,27,29,17,41,25,13,40,48,46
252,10/02/96,Middlesbrough,Newcastle,1,2,A,24,19,31,-5,57,25,28,47,33,26
253,10/02/96,Nott'm Forest,Arsenal,0,1,A,25,25,34,1,38,25,8,33,40,35
254,10/02/96,Sheffield Weds,Wimbledon,2,1,H,25,50,38,-5,24,24,-15,35,26,33
255,11/02/96,QPR,Liverpool,1,2,A,25,21,38,-20,46,25,27,48,18,18
256,12/02/96,Tottenham,West Ham,0,1,A,24,35,24,9,29,25,-9,26,42,33
257,17/02/96,Chelsea,West Ham,1,2,A,25,35,26,4,32,26,-8,27,39,30
258,17/02/96,Middlesbrough,Bolton,1,4,A,26,51,33,-6,13,26,-27,24,33,27
259,17/02/96,Sheffield Weds,QPR,1,3,A,26,40,39,-4,18,25,-21,19,29,35
260,21/02/96,Man United,Everton,2,0,H,26,28,29,18,40,26,11,39,51,47
261,21/02/96,West Ham,Newcastle,2,0,H,25,20,36,-7,60,26,29,49,35,29
262,24/02/96,Blackburn,Liverpool,2,3,A,26,22,28,12,49,26,28,50,41,40
263,24/02/96,Coventry,Middlesbrough,0,0,D,27,37,49,-16,33,26,-9,28,24,33
264,24/02/96,Everton,Nott'm Forest,3,0,H,26,35,30,9,40,27,0,35,40,39
265,24/02/96,Man City,Newcastle,3,3,D,26,22,36,-20,60,26,27,49,24,16
266,24/02/96,Southampton,Chelsea,2,3,A,27,28,36,-11,39,25,3,31,25,25
267,24/02/96,Tottenham,Sheffield Weds,1,0,H,26,42,25,8,29,26,-6,36,42,33
268,24/02/96,West Ham,Arsenal,0,1,A,26,25,36,-5,41,27,9,34,38,31
269,24/02/96,Wimbledon,Aston Villa,3,3,D,25,18,52,-16,45,26,16,34,24,36
270,25/02/96,Bolton,Man United,0,6,A,27,29,52,-24,54,27,20,49,16,28
271,28/02/96,Aston Villa,Blackburn,2,0,H,27,31,21,16,41,26,11,42,46,37
272,02/03/96,Coventry,West Ham,2,2,D,28,37,49,-16,38,27,-6,31,25,33
273,02/03/96,Leeds,Bolton,0,1,A,28,58,37,-6,16,25,-30,28,35,31
274,02/03/96,Man City,Blackburn,1,1,D,28,33,39,-20,41,27,9,42,25,19
275,02/03/96,Middlesbrough,Everton,0,2,A,28,30,37,-9,43,28,12,42,34,28
276,02/03/96,QPR,Arsenal,1,1,D,27,25,41,-19,44,27,10,35,21,22
277,02/03/96,Sheffield Weds,Nott'm Forest,1,3,A,27,38,43,-7,40,27,-3,35,29,36
278,02/03/96,Tottenham,Southampton,1,0,H,26,39,25,9,25,27,-12,27,45,34
279,02/03/96,Wimbledon,Chelsea,1,1,D,28,30,55,-16,42,27,4,34,25,39
280,03/03/96,Liverpool,Aston Villa,3,0,H,27,21,24,29,49,27,18,39,52,53
281,04/03/96,Newcastle,Man United,0,1,A,28,29,25,27,57,27,26,55,61,52
282,05/03/96,Arsenal,Man City,3,1,H,28,40,26,10,26,28,-20,20,45,36
283,06/03/96,Aston Villa,Sheffield Weds,3,2,H,28,46,24,15,29,28,-9,37,49,39
284,06/03/96,QPR,Leeds,1,2,A,26,38,42,-19,35,28,-7,31,22,23
285,09/03/96,Aston Villa,QPR,4,2,H,29,44,26,16,22,29,-20,24,52,42
286,09/03/96,Everton,Coventry,2,2,D,28,51,30,14,26,29,-16,35,46,44
287,09/03/96,West Ham,Middlesbrough,2,0,H,29,39,39,-6,34,29,-11,28,39,33
288,12/03/96,Chelsea,Man City,1,1,D,29,43,31,4,26,29,-22,21,43,35
289,13/03/96,Blackburn,Leeds,1,0,H,27,39,34,9,38,29,-6,33,42,43
290,13/03/96,Liverpool,Wimbledon,2,2,D,28,56,24,32,26,28,-16,40,55,56
291,16/03/96,Coventry,Bolton,0,2,A,29,58,53,-16,19,29,-29,29,27,37
292,16/03/96,Liverpool,Chelsea,2,0,H,30,32,26,32,44,29,4,36,56,58
293,16/03/96,Man City,Southampton,2,1,H,27,40,44,-22,25,30,-13,27,27,22
294,16/03/96,Middlesbrough,Nott'm Forest,1,1,D,28,39,41,-13,43,30,-1,38,34,28
295,16/03/96,QPR,Man United,1,1,D,29,29,48,-22,60,30,27,56,22,26
296,16/03/96,Sheffield Weds,Aston Villa,2,0,H,30,28,49,-10,55,29,18,46,29,39
297,16/03/96,Tottenham,Blackburn,2,3,A,30,34,25,10,45,28,10,44,48,35
298,16/03/96,Wimbledon,Arsenal,0,3,A,29,27,58,-16,48,29,12,39,27,42
299,17/03/96,Leeds,Everton,2,2,D,30,32,40,-7,47,28,14,46,38,33
300,18/03/96,Newcastle,West Ham,3,0,H,30,39,26,26,42,28,-4,35,61,52
301,19/03/96,Aston Villa,Middlesbrough,0,0,D,31,42,30,16,35,31,-13,29,55,46
302,20/03/96,Bolton,Tottenham,2,3,A,29,28,58,-27,48,30,9,37,22,31
303,20/03/96,Man United,Arsenal,1,0,H,30,27,30,27,51,30,15,42,61,57
304,20/03/96,Southampton,Sheffield Weds,0,1,A,30,49,42,-14,32,28,-8,41,25,28
305,23/03/96,Arsenal,Newcastle,2,0,H,29,26,28,14,64,31,29,55,51,42
306,23/03/96,Bolton,Sheffield Weds,2,1,H,31,49,61,-28,35,31,-7,42,22,33
307,23/03/96,Chelsea,QPR,1,1,D,31,49,34,2,23,31,-22,27,44,36
308,23/03/96,Everton,Wimbledon,2,4,A,30,61,34,14,27,31,-19,42,48,48
309,23/03/96,Nott'm Forest,Liverpool,1,0,H,30,26,40,-1,59,29,34,60,44,39
310,23/03/96,West Ham,Man City,4,2,H,31,45,42,-7,30,31,-21,24,42,35
311,24/03/96,Man United,Tottenham,1,0,H,30,30,30,28,51,31,10,40,64,58
312,25/03/96,Southampton,Coventry,1,0,H,30,55,43,-15,27,29,-18,37,25,28
313,30/03/96,Blackburn,Everton,0,3,A,32,38,36,11,48,31,12,50,48,47
314,30/03/96,Bolton,Man City,1,1,D,32,49,62,-27,30,32,-23,26,25,35
315,30/03/96,Leeds,Middlesbrough,0,1,A,32,42,42,-7,36,29,-13,29,39,35
316,30/03/96,QPR,Southampton,3,0,H,30,43,50,-22,28,32,-14,29,24,28
317,30/03/96,Tottenham,Coventry,3,1,H,31,56,31,9,27,31,-19,37,51,40
318,30/03/96,Wimbledon,Nott'm Forest,1,0,H,30,40,63,-17,47,31,0,40,30,46
319,03/04/96,Leeds,Southampton,1,0,H,31,46,43,-8,28,30,-17,29,39,35
320,03/04/96,Liverpool,Newcastle,4,3,H,30,28,27,33,64,31,27,55,59,60
321,05/04/96,Middlesbrough,Sheffield Weds,3,1,H,32,51,42,-12,35,33,-8,43,39,30
322,06/04/96,Arsenal,Leeds,2,1,H,31,43,28,16,42,32,-7,36,54,44
323,06/04/96,Chelsea,Aston Villa,1,2,A,32,30,35,2,56,32,16,46,45,37
324,06/04/96,Coventry,Liverpool,1,0,H,32,30,59,-21,62,32,34,64,27,38
325,06/04/96,Everton,Bolton,3,0,H,33,63,38,15,26,33,-27,36,51,53
326,06/04/96,Man City,Man United,2,3,A,32,30,50,-23,67,33,29,59,31,27
327,06/04/96,Newcastle,QPR,2,1,H,33,50,32,26,27,31,-19,31,64,58
328,06/04/96,Nott'm Forest,Tottenham,2,1,H,32,32,41,-1,54,31,11,43,47,40
329,06/04/96,Southampton,Blackburn,1,0,H,32,39,47,-18,48,32,8,47,28,29
330,06/04/96,West Ham,Wimbledon,1,1,D,32,63,44,-5,33,32,-16,47,45,39
331,08/04/96,Aston Villa,Southampton,3,0,H,33,47,31,17,31,33,-17,30,59,48
332,08/04/96,Blackburn,Newcastle,2,1,H,32,33,40,7,67,33,27,60,48,47
333,08/04/96,Bolton,Chelsea,2,1,H,33,37,66,-30,45,34,1,38,26,36
334,08/04/96,Leeds,Nott'm Forest,1,3,A,32,42,45,-8,50,32,0,42,42,37
335,08/04/96,Liverpool,West Ham,2,0,H,33,45,31,33,46,33,-5,40,62,64
336,08/04/96,Man United,Coventry,1,0,H,33,59,32,30,30,33,-20,39,70,62
337,08/04/96,QPR,Everton,3,1,H,34,38,52,-20,54,34,18,56,27,32
338,08/04/96,Sheffield Weds,Arsenal,1,0,H,33,29,54,-10,57,33,17,46,35,44
339,08/04/96,Tottenham,Middlesbrough,1,1,D,34,43,34,10,42,33,-10,33,54,44
340,08/04/96,Wimbledon,Man City,3,0,H,34,53,64,-16,31,33,-24,29,34,48
341,13/04/96,Chelsea,Leeds,4,1,H,33,48,39,0,42,34,-10,38,45,39
342,13/04/96,Coventry,QPR,1,0,H,35,53,60,-21,30,34,-18,35,30,39
343,13/04/96,Man City,Sheffield Weds,1,0,H,34,54,56,-27,38,35,-9,45,31,29
344,13/04/96,Middlesbrough,Wimbledon,1,2,A,34,64,44,-10,37,35,-13,51,43,34
345,13/04/96,Nott'm Forest,Blackburn,1,5,A,34,41,43,2,51,33,8,49,53,45
346,13/04/96,Southampton,Man United,3,1,H,34,32,50,-20,73,34,31,63,31,30
347,13/04/96,West Ham,Bolton,1,0,H,35,67,47,-7,29,34,-29,38,46,40
348,14/04/96,Newcastle,Aston Villa,1,0,H,34,31,35,26,62,33,20,51,67,61
349,15/04/96,Arsenal,Tottenham,0,0,D,34,35,30,16,55,34,10,45,57,46
350,16/04/96,Everton,Liverpool,1,1,D,34,31,41,16,65,35,35,66,54,57
351,17/04/96,Aston Villa,West Ham,1,1,D,35,47,32,19,49,35,-6,41,62,51
352,17/04/96,Blackburn,Wimbledon,3,2,H,35,65,42,12,40,35,-12,53,54,54
353,17/04/96,Man United,Leeds,1,0,H,34,52,35,29,42,35,-13,39,73,64
354,17/04/96,Newcastle,Southampton,1,0,H,35,51,35,27,34,34,-18,33,70,62
355,17/04/96,Nott'm Forest,Coventry,0,0,D,35,60,48,-2,33,34,-20,40,53,46
356,17/04/96,Sheffield Weds,Chelsea,0,0,D,35,40,55,-10,48,35,3,43,38,45
357,27/04/96,Aston Villa,Man City,0,1,A,36,56,33,19,34,36,-26,30,63,52
358,27/04/96,Blackburn,Arsenal,1,1,D,35,30,44,13,58,36,16,46,57,57
359,27/04/96,Bolton,Southampton,0,1,A,36,52,68,-30,34,36,-19,33,29,38
360,27/04/96,Liverpool,Middlesbrough,1,0,H,36,46,32,35,43,35,-11,35,66,67
361,27/04/96,QPR,West Ham,3,0,H,36,48,54,-19,50,36,-6,42,30,35
362,27/04/96,Sheffield Weds,Everton,2,5,A,36,42,55,-10,55,36,16,58,39,45
363,27/04/96,Tottenham,Chelsea,1,1,D,36,40,35,10,49,35,3,43,56,45
364,27/04/96,Wimbledon,Coventry,0,2,A,36,60,68,-13,34,36,-20,40,40,55
365,28/04/96,Man United,Nott'm Forest,5,0,H,35,48,35,30,54,36,-2,46,76,65
366,29/04/96,Leeds,Newcastle,0,1,A,35,35,53,-14,73,35,28,63,42,39
367,01/05/96,Arsenal,Liverpool,0,0,D,36,32,31,16,69,36,36,68,59,47
368,02/05/96,Leeds,Tottenham,1,3,A,36,36,54,-15,57,36,10,46,42,39
369,02/05/96,Nott'm Forest,Newcastle,1,1,D,36,35,53,-7,76,36,29,64,54,46
370,04/05/96,Arsenal,Bolton,2,1,H,37,69,31,16,29,37,-31,38,60,47
371,04/05/96,Chelsea,Blackburn,2,3,A,37,45,41,3,58,37,13,58,50,44
372,04/05/96,Coventry,Leeds,0,0,D,37,57,60,-18,42,37,-17,40,37,42
373,04/05/96,Everton,Aston Villa,1,0,H,37,34,44,19,63,37,18,52,58,63
374,04/05/96,Man City,Liverpool,2,2,D,37,32,56,-25,70,37,36,68,37,31
375,04/05/96,Middlesbrough,Man United,0,3,A,37,35,47,-12,79,37,35,70,43,35
376,04/05/96,Newcastle,Tottenham,1,1,D,37,37,36,29,60,37,12,49,77,65
377,04/05/96,Nott'm Forest,QPR,3,0,H,37,54,54,-7,33,37,-16,38,55,47
378,04/05/96,Southampton,Wimbledon,0,0,D,37,70,52,-18,40,37,-15,55,37,34
379,04/05/96,West Ham,Sheffield Weds,1,1,D,37,60,51,-9,39,37,-13,47,50,42
