MatchID,Date,HomeTeam,AwayTeam,FTHG,FTAG,FTR,AT_match_played,AT_goal_against,HT_goal_against,HT_goal_differnece,AT_current_standing,HT_match_played,AT_goal_differnece,AT_goal_for,HT_current_standing,HT_goal_for
0,17/08/2002,Blackburn,Sunderland,0,0,D,0,0,0,0,0,0,0,0,0,0
1,17/08/2002,Charlton,Chelsea,2,3,A,0,0,0,0,0,0,0,0,0,0
2,17/08/2002,Everton,Tottenham,2,2,D,0,0,0,0,0,0,0,0,0,0
3,17/08/2002,Fulham,Bolton,4,1,H,0,0,0,0,0,0,0,0,0,0
4,17/08/2002,Leeds,Man City,3,0,H,0,0,0,0,0,0,0,0,0,0
5,17/08/2002,Man United,West Brom,1,0,H,0,0,0,0,0,0,0,0,0,0
6,17/08/2002,Southampton,Middlesboro,0,0,D,0,0,0,0,0,0,0,0,0,0
7,18/08/2002,Arsenal,Birmingham,2,0,H,0,0,0,0,0,0,0,0,0,0
8,18/08/2002,Aston Villa,Liverpool,0,1,A,0,0,0,0,0,0,0,0,0,0
9,19/08/2002,Newcastle,West Ham,4,0,H,0,0,0,0,0,0,0,0,0,0
10,23/08/2002,Chelsea,Man United,2,2,D,1,0,2,1,3,1,1,1,3,3
11,24/08/2002,Birmingham,Blackburn,0,1,A,1,0,2,-2,1,1,0,0,0,0
12,24/08/2002,Bolton,Charlton,1,2,A,1,3,4,-3,0,1,-1,2,0,1
13,24/08/2002,Liverpool,Southampton,3,0,H,1,0,0,1,1,1,0,0,3,1
14,24/08/2002,Man City,Newcastle,1,0,H,1,0,3,-3,3,1,4,4,0,0
15,24/08/2002,Middlesboro,Fulham,2,2,D,1,1,0,0,3,1,3,4,1,0
16,24/08/2002,Sunderland,Everton,0,1,A,1,2,0,0,1,1,0,2,1,0
17,24/08/2002,Tottenham,Aston Villa,1,0,H,1,1,2,0,0,1,-1,0,1,2
18,24/08/2002,West Brom,Leeds,1,3,A,1,0,1,-1,3,1,3,3,0,0
19,24/08/2002,West Ham,Arsenal,2,2,D,1,0,4,-4,3,1,2,2,0,0
20,27/08/2002,Arsenal,West Brom,5,2,H,2,4,2,2,0,2,-3,1,4,4
21,27/08/2002,Charlton,Tottenham,0,1,A,2,2,4,0,4,2,1,3,3,4
22,28/08/2002,Aston Villa,Man City,1,0,H,2,3,2,-2,3,2,-2,1,0,0
23,28/08/2002,Blackburn,Liverpool,2,2,D,2,0,0,1,6,2,4,4,4,1
24,28/08/2002,Everton,Birmingham,1,1,D,2,3,2,1,0,2,-3,0,4,3
25,28/08/2002,Leeds,Sunderland,0,1,A,2,1,1,5,1,2,-1,0,6,6
26,28/08/2002,Southampton,Chelsea,1,1,D,2,4,3,-3,4,2,1,5,1,0
27,31/08/2002,Birmingham,Leeds,2,1,H,3,2,4,-3,6,3,4,6,1,1
28,31/08/2002,Man City,Everton,3,1,H,3,3,4,-3,5,3,1,4,3,1
29,31/08/2002,Middlesboro,Blackburn,1,0,H,3,2,2,0,5,2,1,3,2,2
30,31/08/2002,Sunderland,Man United,1,1,D,2,2,1,0,4,3,1,3,4,1
31,31/08/2002,Tottenham,Southampton,2,1,H,3,4,2,2,2,3,-3,1,7,4
32,31/08/2002,West Brom,Fulham,1,0,H,2,3,9,-6,4,3,3,6,0,3
33,31/08/2002,West Ham,Charlton,0,2,A,3,5,6,-4,3,2,-1,4,1,2
34,01/09/2002,Bolton,Aston Villa,1,0,H,3,2,6,-4,3,2,-1,1,0,2
35,01/09/2002,Chelsea,Arsenal,1,1,D,3,4,5,1,7,3,5,9,5,6
36,02/09/2002,Liverpool,Newcastle,2,2,D,2,1,2,4,3,3,3,4,7,6
37,03/09/2002,Man United,Middlesboro,1,0,H,3,2,3,1,5,3,1,3,5,4
38,10/09/2002,Arsenal,Man City,2,1,H,4,5,5,5,6,4,-1,4,8,10
39,10/09/2002,Middlesboro,Sunderland,3,0,H,4,2,3,0,5,4,0,2,5,3
40,11/09/2002,Aston Villa,Charlton,2,0,H,4,5,3,-2,6,4,1,6,3,1
41,11/09/2002,Blackburn,Chelsea,2,3,A,4,6,3,0,6,4,1,7,5,3
42,11/09/2002,Fulham,Tottenham,3,2,H,4,3,4,2,10,3,3,6,4,6
43,11/09/2002,Liverpool,Birmingham,2,2,D,4,5,4,4,4,4,-2,3,8,8
44,11/09/2002,Man United,Bolton,0,1,A,3,6,3,2,3,4,-3,3,8,5
45,11/09/2002,Newcastle,Leeds,0,2,A,4,4,3,3,6,3,3,7,4,6
46,11/09/2002,Southampton,Everton,1,0,H,4,6,6,-4,5,4,-1,5,2,2
47,11/09/2002,West Ham,West Brom,0,1,A,4,9,8,-6,3,3,-5,4,1,2
48,14/09/2002,Bolton,Liverpool,2,3,A,5,6,6,-2,9,4,4,10,6,4
49,14/09/2002,Charlton,Arsenal,0,3,A,5,6,7,-1,11,5,6,12,6,6
50,14/09/2002,Chelsea,Newcastle,3,0,H,4,5,8,2,4,5,1,6,9,10
51,14/09/2002,Everton,Middlesboro,2,1,H,5,3,7,-2,8,5,3,6,5,5
52,14/09/2002,Leeds,Man United,1,0,H,5,4,4,5,8,5,1,5,9,9
53,14/09/2002,Sunderland,Fulham,0,3,A,4,6,5,-3,7,5,3,9,5,2
54,14/09/2002,West Brom,Southampton,1,0,H,5,6,9,-4,5,5,-3,3,6,5
55,15/09/2002,Man City,Blackburn,2,2,D,5,6,7,-2,5,5,-1,5,6,5
56,15/09/2002,Tottenham,West Ham,3,2,H,4,9,6,2,1,5,-7,2,10,8
57,16/09/2002,Birmingham,Aston Villa,3,0,H,5,3,7,-2,6,5,0,3,5,5
58,21/09/2002,Arsenal,Bolton,2,1,H,5,9,6,9,6,6,-3,6,14,15
59,21/09/2002,Liverpool,West Brom,2,0,H,6,9,8,5,9,6,-3,6,12,13
60,21/09/2002,Man United,Tottenham,1,0,H,6,8,5,0,13,6,3,11,8,5
61,21/09/2002,Middlesboro,Birmingham,1,0,H,6,7,5,2,8,6,1,8,8,7
62,21/09/2002,Newcastle,Sunderland,2,0,H,6,8,8,-2,5,5,-6,2,4,6
63,21/09/2002,Southampton,Charlton,0,0,D,6,10,7,-4,6,6,-4,6,5,3
64,21/09/2002,West Ham,Man City,0,0,D,6,9,12,-8,7,5,-2,7,1,4
65,22/09/2002,Aston Villa,Everton,3,2,H,6,8,6,-3,8,6,-1,7,6,3
66,22/09/2002,Blackburn,Leeds,1,0,H,6,4,8,-1,12,6,6,10,6,7
67,23/09/2002,Fulham,Chelsea,0,0,D,6,8,6,6,12,5,5,13,10,12
68,28/09/2002,Birmingham,Newcastle,0,2,A,6,8,8,0,7,7,0,8,8,8
69,28/09/2002,Bolton,Southampton,1,1,D,7,7,11,-4,6,6,-4,3,6,7
70,28/09/2002,Charlton,Man United,1,3,A,7,5,10,-4,11,7,1,6,7,6
71,28/09/2002,Chelsea,West Ham,2,3,A,6,12,8,5,2,7,-8,4,13,13
72,28/09/2002,Everton,Fulham,2,0,H,6,6,11,-2,11,7,6,12,8,9
73,28/09/2002,Leeds,Arsenal,1,4,A,7,7,5,5,17,7,10,17,12,10
74,28/09/2002,Man City,Liverpool,0,3,A,7,8,9,-2,15,7,7,15,8,7
75,28/09/2002,Sunderland,Aston Villa,1,0,H,7,8,10,-8,9,7,-2,6,5,2
76,28/09/2002,Tottenham,Middlesboro,0,3,A,7,5,9,2,11,7,3,8,13,11
77,30/09/2002,West Brom,Blackburn,0,2,A,7,8,11,-5,9,7,0,8,9,6
78,05/10/2002,Middlesboro,Bolton,2,0,H,7,12,5,6,7,8,-4,8,14,11
79,05/10/2002,Newcastle,West Brom,2,1,H,8,13,8,2,9,7,-7,6,10,10
80,05/10/2002,Southampton,Man City,2,0,H,8,12,8,-4,8,8,-5,7,7,4
81,05/10/2002,West Ham,Birmingham,1,2,A,8,10,14,-7,8,7,-2,8,5,7
82,06/10/2002,Arsenal,Sunderland,3,1,H,8,10,8,13,8,8,-7,3,20,21
83,06/10/2002,Aston Villa,Leeds,0,0,D,8,9,9,-3,12,8,2,11,9,6
84,06/10/2002,Blackburn,Tottenham,1,2,A,8,12,8,2,13,8,-1,11,12,10
85,06/10/2002,Fulham,Charlton,1,0,H,8,13,8,4,7,7,-6,7,11,12
86,06/10/2002,Liverpool,Chelsea,1,0,H,8,11,8,10,13,8,4,15,18,18
87,07/10/2002,Man United,Everton,3,0,H,8,11,6,3,11,8,0,11,14,9
88,19/10/2002,Blackburn,Newcastle,5,2,H,8,9,10,1,13,9,3,12,12,11
89,19/10/2002,Everton,Arsenal,2,1,H,9,9,14,-3,23,9,15,24,11,11
90,19/10/2002,Fulham,Man United,1,1,D,9,6,8,5,17,8,6,12,14,13
91,19/10/2002,Leeds,Liverpool,0,1,A,9,8,9,2,21,9,11,19,13,11
92,19/10/2002,Man City,Chelsea,0,3,A,9,12,14,-7,13,9,3,15,8,7
93,19/10/2002,Sunderland,West Ham,0,1,A,8,16,13,-9,5,9,-8,8,8,4
94,19/10/2002,West Brom,Birmingham,1,1,D,9,11,15,-8,11,9,-1,10,9,7
95,20/10/2002,Charlton,Middlesboro,1,0,H,9,5,14,-7,17,9,8,13,7,7
96,20/10/2002,Tottenham,Bolton,3,1,H,8,14,13,0,7,9,-6,8,16,13
97,21/10/2002,Aston Villa,Southampton,0,1,A,9,8,9,-3,10,9,-2,6,10,6
98,23/10/2002,Fulham,West Ham,0,1,A,9,16,9,5,8,9,-7,9,15,14
99,26/10/2002,Arsenal,Blackburn,1,2,A,10,12,11,14,15,10,4,16,23,25
100,26/10/2002,Birmingham,Man City,0,2,A,10,17,12,-1,8,10,-10,7,12,11
101,26/10/2002,Chelsea,West Brom,2,0,H,10,16,12,6,10,10,-8,8,16,18
102,26/10/2002,Liverpool,Tottenham,2,1,H,10,14,8,12,19,10,2,16,24,20
103,26/10/2002,Man United,Aston Villa,1,1,D,10,10,7,6,10,10,-4,6,18,13
104,26/10/2002,Middlesboro,Leeds,2,2,D,10,10,6,7,13,10,1,11,17,13
105,26/10/2002,Newcastle,Charlton,2,1,H,10,14,14,0,10,9,-6,8,13,14
106,27/10/2002,Southampton,Fulham,4,2,H,10,10,8,-1,15,10,4,14,13,7
107,27/10/2002,West Ham,Everton,0,1,A,10,15,16,-6,14,10,-2,13,11,10
108,28/10/2002,Bolton,Sunderland,1,1,D,10,14,17,-8,8,9,-10,4,7,9
109,02/11/2002,Birmingham,Bolton,3,1,H,10,18,14,-3,8,11,-8,10,12,11
110,02/11/2002,Liverpool,West Ham,2,0,H,11,17,9,13,11,11,-7,10,27,22
111,02/11/2002,Man United,Southampton,2,1,H,11,10,8,6,16,11,1,11,19,14
112,02/11/2002,West Brom,Man City,1,2,A,11,17,18,-10,11,11,-8,9,10,8
113,03/11/2002,Blackburn,Aston Villa,0,0,D,11,11,13,5,11,11,-4,7,18,18
114,03/11/2002,Charlton,Sunderland,1,1,D,11,15,16,-7,9,11,-10,5,10,9
115,03/11/2002,Fulham,Arsenal,0,1,A,11,13,14,2,23,11,13,26,15,16
116,03/11/2002,Leeds,Everton,0,1,A,11,15,12,1,17,11,-1,14,14,13
117,03/11/2002,Tottenham,Chelsea,0,0,D,11,12,16,1,19,11,8,20,19,17
118,04/11/2002,Newcastle,Middlesboro,2,0,H,11,8,15,1,18,10,7,15,16,16
119,09/11/2002,Arsenal,Newcastle,1,0,H,11,15,13,14,19,12,3,18,26,27
120,09/11/2002,Aston Villa,Fulham,3,1,H,12,15,11,-4,15,12,1,16,12,7
121,09/11/2002,Bolton,West Brom,1,1,D,12,20,21,-10,10,11,-11,9,8,11
122,09/11/2002,Chelsea,Birmingham,3,0,H,12,15,12,8,15,12,-1,14,20,20
123,09/11/2002,Everton,Charlton,1,0,H,12,17,15,0,11,12,-7,10,20,15
124,09/11/2002,Man City,Man United,3,1,H,12,9,18,-7,22,12,7,16,14,11
125,09/11/2002,Middlesboro,Liverpool,1,0,H,12,9,10,5,30,12,15,24,18,15
126,09/11/2002,Southampton,Blackburn,1,1,D,12,13,12,0,19,12,5,18,16,12
127,10/11/2002,Sunderland,Tottenham,2,0,H,12,16,16,-10,20,12,1,17,10,6
128,10/11/2002,West Ham,Leeds,3,4,A,12,13,19,-9,14,12,0,13,11,10
129,16/11/2002,Arsenal,Tottenham,3,0,H,13,18,13,15,20,13,-1,17,29,28
130,16/11/2002,Chelsea,Middlesboro,1,0,H,13,10,12,11,21,13,6,16,23,23
131,16/11/2002,Man City,Charlton,0,1,A,13,18,19,-5,11,13,-8,10,17,14
132,16/11/2002,Newcastle,Southampton,2,1,H,13,13,16,2,17,12,0,13,19,18
133,16/11/2002,West Brom,Aston Villa,0,0,D,13,12,21,-11,15,13,-2,10,11,10
134,17/11/2002,Birmingham,Fulham,0,0,D,13,18,18,-4,15,13,-1,17,15,14
135,17/11/2002,Blackburn,Everton,0,1,A,13,15,14,5,23,13,1,16,20,19
136,17/11/2002,Leeds,Bolton,2,4,A,12,22,16,1,9,13,-10,12,17,17
137,17/11/2002,Liverpool,Sunderland,0,0,D,13,16,10,14,13,13,-8,8,30,24
138,17/11/2002,West Ham,Man United,1,1,D,13,12,23,-10,22,13,5,17,11,13
139,23/11/2002,Aston Villa,West Ham,4,1,H,14,24,12,-2,12,14,-10,14,16,10
140,23/11/2002,Bolton,Chelsea,1,1,D,14,12,24,-8,26,13,12,24,12,16
141,23/11/2002,Everton,West Brom,1,0,H,14,21,15,2,12,14,-11,10,26,17
142,23/11/2002,Fulham,Liverpool,3,2,H,14,10,18,-1,31,14,14,24,16,17
143,23/11/2002,Man United,Newcastle,5,3,H,13,17,13,5,22,14,3,20,23,18
144,23/11/2002,Middlesboro,Man City,3,1,H,14,20,11,5,17,14,-6,14,21,16
145,23/11/2002,Southampton,Arsenal,3,2,H,14,13,15,-1,32,14,18,31,17,14
146,23/11/2002,Sunderland,Birmingham,0,1,A,14,18,16,-8,16,14,-4,14,14,8
147,24/11/2002,Charlton,Blackburn,3,1,H,14,15,18,-7,20,14,4,19,14,11
148,24/11/2002,Tottenham,Leeds,2,0,H,14,20,21,-4,17,14,-1,19,20,17
149,30/11/2002,Arsenal,Aston Villa,3,1,H,15,13,16,17,19,15,1,14,32,33
150,30/11/2002,Birmingham,Tottenham,1,1,D,15,21,18,-3,23,15,-2,19,19,15
151,30/11/2002,Blackburn,Fulham,2,1,H,15,20,18,2,19,15,0,20,20,20
152,30/11/2002,Chelsea,Sunderland,3,0,H,15,17,13,12,14,15,-9,8,27,25
153,30/11/2002,Man City,Bolton,2,0,H,14,25,23,-8,13,15,-8,17,17,15
154,30/11/2002,West Brom,Middlesboro,1,0,H,15,12,22,-12,24,15,7,19,12,10
155,01/12/2002,Leeds,Charlton,1,2,A,15,19,22,-3,17,15,-5,14,17,19
156,01/12/2002,Liverpool,Man United,1,2,A,15,16,13,13,26,15,7,23,31,26
157,01/12/2002,Newcastle,Everton,2,1,H,15,15,22,1,29,14,3,18,22,23
158,02/12/2002,West Ham,Southampton,0,1,A,15,17,28,-13,20,15,0,17,12,15
159,07/12/2002,Aston Villa,Newcastle,0,1,A,15,23,16,-1,25,16,2,25,19,15
160,07/12/2002,Bolton,Blackburn,1,1,D,16,19,27,-10,23,15,3,22,13,17
161,07/12/2002,Charlton,Liverpool,2,0,H,16,15,20,-4,31,16,12,27,20,16
162,07/12/2002,Everton,Chelsea,1,3,A,16,13,17,2,30,16,15,28,29,19
163,07/12/2002,Fulham,Leeds,1,0,H,16,24,22,-1,17,16,-4,20,19,21
164,07/12/2002,Man United,Arsenal,2,0,H,16,17,17,8,35,16,19,36,29,25
165,07/12/2002,Middlesboro,West Ham,2,2,D,16,29,13,6,12,16,-14,15,24,19
166,07/12/2002,Southampton,Birmingham,2,0,H,16,19,17,1,20,16,-3,16,23,18
167,08/12/2002,Tottenham,West Brom,3,1,H,16,22,22,-2,15,16,-11,11,24,20
168,09/12/2002,Sunderland,Man City,0,3,A,16,23,20,-12,20,16,-6,17,14,8
169,14/12/2002,Aston Villa,West Brom,2,1,H,17,25,17,-2,15,17,-13,12,19,15
170,14/12/2002,Charlton,Man City,2,2,D,17,23,20,-2,23,17,-3,20,23,18
171,14/12/2002,Everton,Blackburn,2,1,H,17,20,20,0,24,17,3,23,29,20
172,14/12/2002,Man United,West Ham,3,0,H,17,31,17,10,13,17,-14,17,32,27
173,14/12/2002,Middlesboro,Chelsea,1,1,D,17,14,15,6,33,17,17,31,25,21
174,14/12/2002,Southampton,Newcastle,1,1,D,16,23,17,3,28,17,3,26,26,20
175,15/12/2002,Fulham,Birmingham,0,1,A,17,21,22,0,20,17,-5,16,22,22
176,15/12/2002,Sunderland,Liverpool,2,1,H,17,17,23,-15,31,17,10,27,14,8
177,15/12/2002,Tottenham,Arsenal,1,1,D,17,19,23,0,35,17,17,36,27,23
178,16/12/2002,Bolton,Leeds,0,3,A,17,25,28,-10,17,16,-5,20,14,18
179,21/12/2002,Arsenal,Middlesboro,2,0,H,18,16,20,17,26,18,6,22,36,37
180,21/12/2002,Birmingham,Charlton,1,1,D,18,22,21,-4,24,18,-2,20,23,17
181,21/12/2002,Chelsea,Aston Villa,2,0,H,18,18,15,17,22,18,-1,17,34,32
182,21/12/2002,Leeds,Southampton,1,1,D,18,18,25,-2,27,18,3,21,20,23
183,21/12/2002,Newcastle,Fulham,2,0,H,18,23,24,3,22,17,-1,22,29,27
184,21/12/2002,West Brom,Sunderland,2,2,D,18,24,27,-14,17,18,-14,10,15,13
185,21/12/2002,West Ham,Bolton,1,1,D,17,31,34,-17,14,18,-13,18,13,17
186,22/12/2002,Blackburn,Man United,1,0,H,18,17,22,2,35,18,13,30,24,24
187,22/12/2002,Liverpool,Everton,0,0,D,18,21,19,9,32,18,1,22,31,28
188,23/12/2002,Man City,Tottenham,2,3,A,18,24,25,-3,28,18,0,24,24,22
189,26/12/2002,Birmingham,Everton,1,1,D,19,21,22,-4,33,19,1,22,24,18
190,26/12/2002,Bolton,Newcastle,4,3,H,18,24,32,-13,32,18,5,29,15,19
191,26/12/2002,Chelsea,Southampton,0,0,D,19,19,15,19,28,19,3,22,37,34
192,26/12/2002,Liverpool,Blackburn,1,1,D,19,22,19,9,27,19,3,25,32,28
193,26/12/2002,Man City,Aston Villa,3,1,H,19,20,28,-4,22,19,-3,17,24,24
194,26/12/2002,Middlesboro,Man United,3,1,H,19,18,18,4,35,19,12,30,26,22
195,26/12/2002,Sunderland,Leeds,1,2,A,19,26,26,-14,21,19,-2,24,18,12
196,26/12/2002,Tottenham,Charlton,2,2,D,19,23,26,1,25,19,-2,21,31,27
197,26/12/2002,West Brom,Arsenal,1,2,A,19,20,29,-14,39,19,19,39,16,15
198,26/12/2002,West Ham,Fulham,1,1,D,19,25,35,-17,22,19,-3,22,14,18
199,28/12/2002,Aston Villa,Middlesboro,1,0,H,20,19,23,-5,29,20,6,25,22,18
200,28/12/2002,Blackburn,West Ham,2,2,D,20,36,23,3,15,20,-17,19,28,26
201,28/12/2002,Charlton,West Brom,1,0,H,20,31,25,-2,16,20,-15,16,26,23
202,28/12/2002,Everton,Bolton,0,0,D,19,35,22,1,18,20,-12,23,34,23
203,28/12/2002,Fulham,Man City,0,1,A,20,29,26,-3,27,20,-2,27,23,23
204,28/12/2002,Leeds,Chelsea,2,0,H,20,15,27,-1,38,20,19,34,24,26
205,28/12/2002,Man United,Birmingham,2,0,H,20,23,21,10,25,20,-4,19,35,31
206,28/12/2002,Southampton,Sunderland,2,1,H,20,28,19,3,18,20,-15,13,29,22
207,29/12/2002,Arsenal,Liverpool,1,1,D,20,20,21,20,33,20,9,29,42,41
208,29/12/2002,Newcastle,Tottenham,2,1,H,20,28,28,4,32,19,1,29,32,32
209,01/01/2003,Arsenal,Chelsea,3,2,H,21,17,22,20,38,21,17,34,43,42
210,01/01/2003,Aston Villa,Bolton,2,0,H,20,35,23,-4,19,21,-12,23,25,19
211,01/01/2003,Blackburn,Middlesboro,1,0,H,21,20,25,3,29,21,5,25,29,28
212,01/01/2003,Everton,Man City,2,2,D,21,29,22,1,30,21,-1,28,35,23
213,01/01/2003,Leeds,Birmingham,2,0,H,21,25,27,1,25,21,-6,19,27,28
214,01/01/2003,Man United,Sunderland,2,1,H,21,30,21,12,18,21,-16,14,38,33
215,01/01/2003,Newcastle,Liverpool,1,0,H,21,21,29,5,34,20,9,30,35,34
216,01/01/2003,Southampton,Tottenham,1,0,H,21,30,20,4,32,21,0,30,32,24
217,11/01/2003,Bolton,Fulham,0,0,D,21,27,37,-14,23,21,-4,23,19,23
218,11/01/2003,Chelsea,Charlton,4,1,H,21,25,20,16,29,22,-1,24,38,36
219,11/01/2003,Liverpool,Aston Villa,1,1,D,22,23,22,8,28,22,-2,21,34,30
220,11/01/2003,Man City,Leeds,2,1,H,22,27,31,-1,30,22,3,30,31,30
221,11/01/2003,Middlesboro,Southampton,2,2,D,22,20,21,4,35,22,5,25,29,25
222,11/01/2003,Sunderland,Blackburn,0,0,D,22,25,32,-17,32,22,4,29,18,15
223,11/01/2003,West Brom,Man United,1,3,A,22,22,32,-16,41,21,13,35,16,16
224,11/01/2003,West Ham,Newcastle,2,2,D,21,29,38,-17,38,21,6,35,16,21
225,12/01/2003,Birmingham,Arsenal,0,4,A,22,24,27,-8,46,22,21,45,25,19
226,12/01/2003,Tottenham,Everton,4,3,H,22,24,31,-1,36,22,1,25,32,30
227,18/01/2003,Aston Villa,Tottenham,0,1,A,23,34,24,-2,35,23,0,34,29,22
228,18/01/2003,Blackburn,Birmingham,1,1,D,23,31,25,4,25,23,-12,19,33,29
229,18/01/2003,Charlton,Bolton,1,1,D,22,37,29,-4,20,22,-14,23,29,25
230,18/01/2003,Everton,Sunderland,2,1,H,23,32,28,0,19,23,-17,15,36,28
231,18/01/2003,Leeds,West Brom,0,0,D,22,35,29,2,16,23,-18,17,30,31
232,18/01/2003,Man United,Chelsea,2,1,H,23,21,23,15,41,23,19,40,44,38
233,18/01/2003,Newcastle,Man City,2,0,H,23,32,31,6,34,22,0,32,39,37
234,18/01/2003,Southampton,Liverpool,0,1,A,23,23,22,5,35,23,8,31,36,27
235,19/01/2003,Arsenal,West Ham,3,1,H,22,40,24,25,17,23,-17,23,49,49
236,19/01/2003,Fulham,Middlesboro,1,0,H,23,23,27,-4,30,22,4,27,24,23
237,22/01/2003,Charlton,West Ham,4,2,H,23,43,30,-4,17,23,-19,24,30,26
238,22/01/2003,Newcastle,Bolton,1,0,H,23,38,31,8,21,23,-14,24,42,39
239,28/01/2003,Bolton,Everton,1,2,A,24,29,39,-15,39,24,1,30,21,24
240,28/01/2003,Chelsea,Leeds,3,2,H,24,29,23,18,31,24,2,31,41,41
241,28/01/2003,Middlesboro,Aston Villa,2,5,A,24,25,24,3,29,24,-3,22,30,27
242,28/01/2003,Sunderland,Southampton,0,1,A,24,23,34,-18,36,24,4,27,19,16
243,29/01/2003,Liverpool,Arsenal,2,2,D,24,25,23,9,52,24,27,52,38,32
244,29/01/2003,Man City,Fulham,4,1,H,23,27,34,-2,27,24,-3,24,34,32
245,29/01/2003,Tottenham,Newcastle,0,1,A,24,31,34,1,45,24,9,40,38,35
246,29/01/2003,West Brom,Charlton,0,1,A,24,32,35,-18,33,23,-2,30,17,17
247,29/01/2003,West Ham,Blackburn,2,1,H,24,26,47,-21,34,24,4,30,17,26
248,01/02/2003,Arsenal,Fulham,2,1,H,24,31,27,27,27,25,-6,25,53,54
249,01/02/2003,Bolton,Birmingham,4,2,H,24,32,41,-16,26,25,-12,20,21,25
250,01/02/2003,Chelsea,Tottenham,1,1,D,25,35,25,19,38,25,0,35,44,44
251,01/02/2003,Everton,Leeds,2,0,H,25,32,30,2,31,25,1,33,42,32
252,01/02/2003,Man City,West Brom,1,2,A,24,36,35,1,17,25,-19,17,37,36
253,01/02/2003,Southampton,Man United,0,2,A,24,24,23,5,47,25,16,40,39,28
254,01/02/2003,Sunderland,Charlton,1,3,A,25,32,35,-19,36,25,-1,31,19,16
255,02/02/2003,Aston Villa,Blackburn,3,0,H,25,28,27,0,34,25,3,31,32,27
256,02/02/2003,West Ham,Liverpool,0,3,A,25,25,48,-20,39,25,9,34,20,28
257,04/02/2003,Birmingham,Man United,0,1,A,25,24,36,-14,50,25,18,42,26,22
258,08/02/2003,Birmingham,Chelsea,1,3,A,26,26,37,-15,45,26,19,45,26,22
259,08/02/2003,Blackburn,Southampton,1,0,H,26,25,31,0,39,26,3,28,34,31
260,08/02/2003,Charlton,Everton,2,1,H,26,30,33,1,45,26,4,34,39,34
261,08/02/2003,Fulham,Aston Villa,2,1,H,26,27,33,-7,35,25,3,30,27,26
262,08/02/2003,Leeds,West Ham,1,0,H,26,51,34,-1,20,26,-23,28,31,33
263,08/02/2003,Liverpool,Middlesboro,1,1,D,25,29,25,12,30,26,0,29,42,37
264,08/02/2003,Tottenham,Sunderland,4,1,H,26,38,36,0,19,26,-21,17,39,36
265,08/02/2003,West Brom,Bolton,1,1,D,26,43,37,-18,24,25,-14,29,20,19
266,09/02/2003,Man United,Man City,1,1,D,26,37,24,19,37,26,0,37,53,43
267,09/02/2003,Newcastle,Arsenal,1,1,D,26,28,31,10,56,25,28,56,48,41
268,19/02/2003,Fulham,West Brom,3,0,H,26,38,34,-6,21,26,-18,20,30,28
269,22/02/2003,Bolton,Man United,1,1,D,27,25,44,-14,54,27,19,44,25,30
270,22/02/2003,Charlton,Aston Villa,3,0,H,27,29,34,2,35,27,2,31,42,36
271,22/02/2003,Chelsea,Blackburn,1,2,A,27,31,27,21,37,27,1,32,48,48
272,22/02/2003,Everton,Southampton,2,1,H,27,26,32,3,39,27,2,28,45,35
273,22/02/2003,Leeds,Newcastle,0,3,A,26,32,34,0,49,27,10,42,34,34
274,22/02/2003,Man City,Arsenal,1,5,A,27,29,38,0,57,27,28,57,38,38
275,22/02/2003,Sunderland,Middlesboro,1,3,A,26,30,42,-24,31,27,0,30,19,18
276,23/02/2003,Birmingham,Liverpool,2,1,H,27,26,40,-17,43,27,12,38,26,23
277,23/02/2003,West Brom,West Ham,1,2,A,27,52,41,-21,20,27,-24,28,21,20
278,24/02/2003,Tottenham,Fulham,1,1,D,27,34,37,3,33,27,-3,31,42,40
279,01/03/2003,Blackburn,Man City,1,0,H,28,43,32,2,38,28,-4,39,40,34
280,01/03/2003,Fulham,Sunderland,1,0,H,28,45,35,-3,19,28,-26,19,34,32
281,01/03/2003,Middlesboro,Everton,1,1,D,28,33,31,2,48,27,4,37,34,33
282,01/03/2003,Newcastle,Chelsea,2,1,H,28,29,32,13,48,27,20,49,52,45
283,01/03/2003,Southampton,West Brom,1,0,H,28,43,28,1,21,28,-22,21,39,29
284,01/03/2003,West Ham,Tottenham,2,0,H,28,38,53,-23,43,28,3,41,23,30
285,02/03/2003,Arsenal,Charlton,2,0,H,28,34,30,32,45,28,5,39,60,62
286,03/03/2003,Aston Villa,Birmingham,0,2,A,28,41,32,-1,29,28,-16,25,35,31
287,05/03/2003,Man United,Leeds,2,1,H,28,37,26,19,34,28,-3,34,55,45
288,05/03/2003,Middlesboro,Newcastle,1,0,H,28,33,32,2,55,28,14,47,35,34
289,08/03/2003,Liverpool,Bolton,2,0,H,28,45,28,11,26,28,-14,31,43,39
290,15/03/2003,Aston Villa,Man United,0,1,A,29,27,34,-3,58,29,20,47,35,31
291,15/03/2003,Blackburn,Arsenal,2,0,H,29,30,32,3,63,29,34,64,43,35
292,15/03/2003,Charlton,Newcastle,0,2,A,29,34,36,3,55,29,13,47,45,39
293,15/03/2003,Everton,West Ham,0,0,D,29,53,34,4,26,29,-21,32,49,38
294,15/03/2003,Fulham,Southampton,2,2,D,29,28,35,-2,42,29,2,30,37,33
295,15/03/2003,Leeds,Middlesboro,2,3,A,29,32,39,-4,38,29,3,35,34,35
296,15/03/2003,Sunderland,Bolton,0,2,A,29,47,46,-27,26,29,-16,31,19,19
297,16/03/2003,Man City,Birmingham,1,0,H,29,41,44,-5,32,29,-14,27,38,39
298,16/03/2003,Tottenham,Liverpool,2,3,A,29,28,40,1,46,29,13,41,43,41
299,16/03/2003,West Brom,Chelsea,0,2,A,29,31,44,-23,48,29,19,50,21,21
300,22/03/2003,Birmingham,West Brom,1,0,H,30,46,42,-15,21,30,-25,21,32,27
301,22/03/2003,Chelsea,Man City,5,0,H,30,44,31,21,41,30,-4,40,51,52
302,22/03/2003,Man United,Fulham,3,0,H,30,37,27,21,38,30,-2,35,61,48
303,22/03/2003,Middlesboro,Charlton,1,1,D,30,38,34,4,45,30,1,39,41,38
304,22/03/2003,Newcastle,Blackburn,5,1,H,30,32,34,15,46,30,5,37,58,49
305,22/03/2003,Southampton,Aston Villa,2,2,D,30,35,30,2,35,30,-4,31,43,32
306,22/03/2003,West Ham,Sunderland,2,0,H,30,48,53,-21,19,30,-29,19,27,32
307,23/03/2003,Arsenal,Everton,2,1,H,30,34,32,32,50,30,4,38,63,64
308,23/03/2003,Liverpool,Leeds,3,1,H,30,42,30,14,34,30,-5,37,49,44
309,24/03/2003,Bolton,Tottenham,1,0,H,30,43,47,-14,43,30,0,43,29,33
310,05/04/2003,Aston Villa,Arsenal,1,1,D,31,33,37,-4,66,31,33,66,36,33
311,05/04/2003,Bolton,Man City,2,0,H,31,49,47,-13,41,31,-9,40,32,34
312,05/04/2003,Charlton,Leeds,1,6,A,31,45,39,1,34,31,-7,38,46,40
313,05/04/2003,Man United,Liverpool,4,0,H,31,31,27,24,52,31,16,47,64,51
314,05/04/2003,Middlesboro,West Brom,3,0,H,31,47,35,4,21,31,-26,21,42,39
315,05/04/2003,Southampton,West Ham,1,1,D,31,53,32,2,30,31,-19,34,44,34
316,05/04/2003,Sunderland,Chelsea,1,2,A,31,31,50,-31,54,31,26,57,19,19
317,05/04/2003,Tottenham,Birmingham,2,1,H,31,42,44,-1,35,31,-14,28,43,43
318,06/04/2003,Everton,Newcastle,2,1,H,31,35,36,3,61,31,19,54,50,39
319,07/04/2003,Fulham,Blackburn,0,4,A,31,37,40,-5,46,31,1,38,38,35
320,12/04/2003,Birmingham,Sunderland,2,0,H,32,52,44,-15,19,32,-32,20,35,29
321,12/04/2003,Blackburn,Charlton,1,0,H,32,45,37,5,46,32,-4,41,49,42
322,12/04/2003,Chelsea,Bolton,1,0,H,32,47,32,27,35,32,-11,36,57,59
323,12/04/2003,Leeds,Tottenham,2,2,D,32,45,46,-2,46,32,0,45,37,44
324,12/04/2003,Liverpool,Fulham,2,0,H,32,44,35,12,38,32,-9,35,52,47
325,12/04/2003,Man City,Middlesboro,0,0,D,32,35,51,-11,45,32,7,42,41,40
326,12/04/2003,Newcastle,Man United,2,6,A,32,27,37,18,67,32,28,55,61,55
327,12/04/2003,West Brom,Everton,1,2,A,32,37,50,-29,53,32,4,41,21,21
328,12/04/2003,West Ham,Aston Villa,2,2,D,32,38,54,-19,37,32,-4,34,31,35
329,16/04/2003,Arsenal,Man United,2,2,D,33,29,34,33,70,32,32,61,67,67
330,18/04/2003,Tottenham,Man City,0,2,A,33,51,47,0,42,33,-11,40,47,47
331,19/04/2003,Aston Villa,Chelsea,2,1,H,33,32,40,-4,60,33,28,60,38,36
332,19/04/2003,Bolton,West Ham,1,0,H,33,56,48,-12,32,33,-19,37,35,36
333,19/04/2003,Charlton,Birmingham,0,2,A,33,44,46,-5,38,33,-13,31,46,41
334,19/04/2003,Everton,Liverpool,1,2,A,33,35,38,5,55,33,14,49,56,43
335,19/04/2003,Fulham,Newcastle,2,1,H,33,43,46,-11,61,33,14,57,38,35
336,19/04/2003,Man United,Blackburn,3,1,H,33,37,31,32,52,34,6,43,71,63
337,19/04/2003,Middlesboro,Arsenal,0,2,A,33,36,35,7,68,33,33,69,46,42
338,19/04/2003,Southampton,Leeds,3,2,H,33,48,33,2,38,32,-2,46,45,35
339,19/04/2003,Sunderland,West Brom,1,2,A,33,52,54,-34,21,33,-30,22,19,20
340,21/04/2003,Birmingham,Southampton,3,2,H,33,35,44,-11,48,34,3,38,41,33
341,21/04/2003,Blackburn,Bolton,0,0,D,34,48,40,4,38,34,-11,37,52,44
342,21/04/2003,Chelsea,Everton,4,1,H,34,40,34,27,56,34,4,44,60,61
343,21/04/2003,Liverpool,Charlton,2,1,H,34,48,36,15,46,34,-7,41,58,51
344,21/04/2003,Man City,Sunderland,3,0,H,34,56,51,-9,19,34,-35,21,45,42
345,21/04/2003,Newcastle,Aston Villa,1,1,D,34,41,45,13,41,34,-3,38,61,58
346,21/04/2003,West Brom,Tottenham,2,3,A,34,49,53,-29,47,34,-2,47,24,24
347,21/04/2003,West Ham,Middlesboro,1,0,H,34,37,57,-20,46,34,5,42,32,37
348,22/04/2003,Leeds,Fulham,2,0,H,34,47,51,-3,41,34,-10,37,38,48
349,26/04/2003,Birmingham,Middlesboro,3,0,H,35,38,46,-10,46,35,4,42,44,36
350,26/04/2003,Bolton,Arsenal,2,2,D,34,36,48,-11,71,35,35,71,39,37
351,26/04/2003,Charlton,Southampton,2,1,H,34,38,50,-8,48,35,2,40,46,42
352,26/04/2003,Chelsea,Fulham,1,1,D,35,49,35,30,41,35,-12,37,63,65
353,26/04/2003,Everton,Aston Villa,2,1,H,35,42,44,1,42,35,-3,39,56,45
354,26/04/2003,Leeds,Blackburn,2,3,A,35,40,51,-1,53,35,4,44,41,50
355,26/04/2003,Sunderland,Newcastle,0,1,A,35,46,59,-38,62,35,13,59,19,21
356,26/04/2003,West Brom,Liverpool,0,6,A,35,37,56,-30,61,35,16,53,24,26
357,27/04/2003,Man City,West Ham,0,1,A,35,57,51,-6,35,35,-19,38,48,45
358,27/04/2003,Tottenham,Man United,0,2,A,35,32,51,-1,74,35,34,66,50,50
359,03/05/2003,Aston Villa,Sunderland,1,0,H,36,60,44,-4,19,36,-39,21,42,40
360,03/05/2003,Blackburn,West Brom,1,1,D,36,62,42,5,24,36,-36,26,56,47
361,03/05/2003,Fulham,Everton,2,0,H,36,45,50,-12,59,36,2,47,42,38
362,03/05/2003,Liverpool,Man City,1,2,A,36,52,37,22,48,36,-7,45,64,59
363,03/05/2003,Man United,Charlton,4,1,H,36,51,32,36,49,36,-7,44,77,68
364,03/05/2003,Middlesboro,Tottenham,5,1,H,36,53,41,1,50,36,-3,50,46,42
365,03/05/2003,Newcastle,Birmingham,1,0,H,36,46,46,14,47,36,-7,39,65,60
366,03/05/2003,Southampton,Bolton,0,0,D,36,50,40,1,40,35,-11,39,48,41
367,03/05/2003,West Ham,Chelsea,1,0,H,36,36,57,-18,64,36,30,66,38,39
368,04/05/2003,Arsenal,Leeds,2,3,A,36,54,38,35,41,35,-2,52,72,73
369,07/05/2003,Arsenal,Southampton,6,1,H,36,40,41,34,49,36,1,41,72,75
370,11/05/2003,Birmingham,West Ham,2,2,D,37,57,47,-8,41,37,-17,40,47,39
371,11/05/2003,Bolton,Middlesboro,2,1,H,37,42,50,-11,49,37,5,47,41,39
372,11/05/2003,Charlton,Fulham,0,1,A,37,50,55,-10,45,37,-10,40,49,45
373,11/05/2003,Chelsea,Liverpool,2,1,H,37,39,37,29,64,37,21,60,64,66
374,11/05/2003,Everton,Man United,1,2,A,37,33,47,0,80,37,39,72,59,47
375,11/05/2003,Leeds,Aston Villa,3,1,H,37,44,56,-1,45,37,-3,41,44,55
376,11/05/2003,Man City,Southampton,0,1,A,37,46,53,-6,49,37,-4,42,51,47
377,11/05/2003,Sunderland,Arsenal,0,4,A,37,42,61,-40,75,37,39,81,19,21
378,11/05/2003,Tottenham,Blackburn,0,4,A,37,43,58,-7,57,37,5,48,50,51
379,11/05/2003,West Brom,Newcastle,2,2,D,37,46,63,-36,68,37,15,61,25,27
