MatchID,Date,HomeTeam,AwayTeam,FTHG,FTAG,FTR,AT_match_played,AT_goal_against,HT_goal_against,HT_goal_differnece,AT_current_standing,HT_match_played,AT_goal_differnece,AT_goal_for,HT_current_standing,HT_goal_for
0,14/08/04,Aston Villa,Southampton,2,0,H,0,0,0,0,0,0,0,0,0,0
1,14/08/04,Blackburn,West Brom,1,1,D,0,0,0,0,0,0,0,0,0,0
2,14/08/04,Bolton,Charlton,4,1,H,0,0,0,0,0,0,0,0,0,0
3,14/08/04,Man City,Fulham,1,1,D,0,0,0,0,0,0,0,0,0,0
4,14/08/04,Middlesbrough,Newcastle,2,2,D,0,0,0,0,0,0,0,0,0,0
5,14/08/04,Norwich,Crystal Palace,1,1,D,0,0,0,0,0,0,0,0,0,0
6,14/08/04,Portsmouth,Birmingham,1,1,D,0,0,0,0,0,0,0,0,0,0
7,14/08/04,Tottenham,Liverpool,1,1,D,0,0,0,0,0,0,0,0,0,0
8,15/08/04,Chelsea,Man United,1,0,H,0,0,0,0,0,0,0,0,0,0
9,15/08/04,Everton,Arsenal,1,4,A,0,0,0,0,0,0,0,0,0,0
10,21/08/04,Birmingham,Chelsea,0,1,A,1,0,1,0,3,1,1,1,1,1
11,21/08/04,Charlton,Portsmouth,2,1,H,1,1,4,-3,1,1,0,1,0,1
12,21/08/04,Crystal Palace,Everton,1,3,A,1,4,1,0,0,1,-3,1,1,1
13,21/08/04,Fulham,Bolton,2,0,H,1,1,1,0,3,1,3,4,1,1
14,21/08/04,Liverpool,Man City,2,1,H,1,1,1,0,1,1,0,1,1,1
15,21/08/04,Man United,Norwich,2,1,H,1,1,1,-1,1,1,0,1,0,0
16,21/08/04,Newcastle,Tottenham,0,1,A,1,1,2,0,1,1,0,1,1,2
17,21/08/04,Southampton,Blackburn,3,2,H,1,1,2,-2,1,1,0,1,0,0
18,22/08/04,Arsenal,Middlesbrough,5,3,H,1,2,1,3,1,1,0,2,3,4
19,22/08/04,West Brom,Aston Villa,1,1,D,1,0,1,0,3,1,2,2,1,1
20,24/08/04,Birmingham,Man City,1,0,H,2,3,2,-1,1,2,-1,2,1,1
21,24/08/04,Crystal Palace,Chelsea,0,2,A,2,0,4,-2,6,2,2,2,1,2
22,25/08/04,Arsenal,Blackburn,3,0,H,2,4,4,5,1,2,-1,3,6,9
23,25/08/04,Charlton,Aston Villa,3,0,H,2,1,5,-2,4,2,2,3,3,3
24,25/08/04,Fulham,Middlesbrough,0,2,A,2,7,1,2,1,2,-2,5,4,3
25,25/08/04,Newcastle,Norwich,2,2,D,2,3,3,-1,1,2,-1,2,1,2
26,25/08/04,Southampton,Bolton,1,2,A,2,3,4,-1,3,2,1,4,3,3
27,25/08/04,West Brom,Tottenham,1,1,D,2,1,2,0,4,2,1,2,2,2
28,28/08/04,Aston Villa,Newcastle,4,2,H,3,5,4,-1,2,3,-1,4,4,3
29,28/08/04,Blackburn,Man United,1,1,D,2,2,7,-4,3,3,0,2,1,3
30,28/08/04,Chelsea,Southampton,2,1,H,3,6,0,4,3,3,-2,4,9,4
31,28/08/04,Everton,West Brom,2,1,H,3,3,5,-1,3,2,0,3,3,4
32,28/08/04,Man City,Charlton,4,0,H,3,5,4,-2,6,3,1,6,1,2
33,28/08/04,Middlesbrough,Crystal Palace,2,1,H,3,6,7,0,1,3,-4,2,4,7
34,28/08/04,Norwich,Arsenal,1,4,A,3,4,5,-1,9,3,8,12,2,4
35,28/08/04,Tottenham,Birmingham,1,0,H,3,2,2,1,4,3,0,2,5,3
36,29/08/04,Bolton,Liverpool,1,0,H,2,2,4,2,4,3,1,3,6,6
37,30/08/04,Man United,Everton,0,0,D,3,6,3,0,6,3,0,6,4,3
38,30/08/04,Portsmouth,Fulham,4,3,H,3,3,3,-1,4,2,0,3,1,2
39,11/09/04,Aston Villa,Chelsea,0,0,D,4,1,6,1,12,4,5,6,7,7
40,11/09/04,Bolton,Man United,2,2,D,4,3,4,3,5,4,0,3,9,7
41,11/09/04,Fulham,Arsenal,0,3,A,4,5,7,-1,12,4,11,16,4,6
42,11/09/04,Liverpool,West Brom,3,0,H,4,5,3,0,3,3,-1,4,4,3
43,11/09/04,Man City,Everton,0,1,A,4,6,4,2,7,4,0,6,4,6
44,11/09/04,Middlesbrough,Birmingham,2,1,H,4,3,8,1,4,4,-1,2,7,9
45,11/09/04,Newcastle,Blackburn,3,0,H,4,8,9,-3,2,4,-4,4,2,6
46,11/09/04,Portsmouth,Crystal Palace,3,1,H,4,8,6,0,1,3,-5,3,4,6
47,12/09/04,Tottenham,Norwich,0,0,D,4,9,2,2,2,4,-4,5,8,4
48,13/09/04,Charlton,Southampton,0,0,D,4,8,9,-3,3,4,-3,5,6,6
49,18/09/04,Arsenal,Bolton,2,2,D,5,6,5,14,10,5,3,9,15,19
50,18/09/04,Birmingham,Charlton,1,1,D,5,9,5,-2,7,5,-3,6,4,3
51,18/09/04,Blackburn,Portsmouth,1,0,H,4,7,11,-7,7,5,2,9,2,4
52,18/09/04,Crystal Palace,Man City,1,2,A,5,5,11,-7,4,5,1,6,1,4
53,18/09/04,Norwich,Aston Villa,0,0,D,5,6,9,-4,8,5,1,7,3,5
54,18/09/04,West Brom,Fulham,1,1,D,5,10,8,-4,4,5,-4,6,3,4
55,19/09/04,Chelsea,Tottenham,0,0,D,5,2,1,5,9,5,2,4,13,6
56,19/09/04,Everton,Middlesbrough,1,0,H,5,9,6,1,10,5,2,11,10,7
57,19/09/04,Southampton,Newcastle,1,2,A,5,9,8,-3,5,5,0,9,4,5
58,20/09/04,Man United,Liverpool,2,1,H,4,3,5,0,7,5,3,6,6,5
59,25/09/04,Aston Villa,Crystal Palace,1,1,D,6,13,6,1,1,6,-8,5,9,7
60,25/09/04,Bolton,Birmingham,1,1,D,6,6,8,3,5,6,-2,4,11,11
61,25/09/04,Fulham,Southampton,1,0,H,6,10,11,-4,4,6,-4,6,5,7
62,25/09/04,Liverpool,Norwich,3,0,H,6,9,5,2,4,5,-4,5,7,7
63,25/09/04,Man City,Arsenal,0,1,A,6,7,6,2,16,6,14,21,7,8
64,25/09/04,Middlesbrough,Chelsea,0,1,A,6,1,10,1,14,6,5,6,10,11
65,25/09/04,Newcastle,West Brom,3,1,H,6,9,10,1,4,6,-4,5,8,11
66,25/09/04,Tottenham,Man United,0,1,A,6,6,2,2,9,6,1,7,10,4
67,26/09/04,Portsmouth,Everton,0,1,A,6,6,8,1,13,5,2,8,7,9
68,27/09/04,Charlton,Blackburn,1,0,H,6,11,10,-3,5,6,-6,5,8,7
69,02/10/04,Arsenal,Charlton,4,0,H,7,10,7,15,11,7,-2,8,19,22
70,02/10/04,Blackburn,Aston Villa,2,2,D,7,7,12,-7,10,7,1,8,5,5
71,02/10/04,Everton,Tottenham,0,1,A,7,3,6,3,10,7,1,4,16,9
72,02/10/04,Norwich,Portsmouth,2,2,D,6,9,12,-7,7,7,0,9,4,5
73,02/10/04,Southampton,Man City,0,0,D,7,7,11,-5,7,7,1,8,4,6
74,02/10/04,West Brom,Bolton,2,1,H,7,9,12,-6,12,7,3,12,4,6
75,03/10/04,Birmingham,Newcastle,2,2,D,7,11,7,-2,11,7,3,14,6,5
76,03/10/04,Chelsea,Liverpool,1,0,H,6,5,1,6,10,7,5,10,17,7
77,03/10/04,Man United,Middlesbrough,1,1,D,7,11,6,2,10,7,0,11,12,8
78,04/10/04,Crystal Palace,Fulham,2,0,H,7,11,14,-8,8,7,-3,8,2,6
79,16/10/04,Arsenal,Aston Villa,3,1,H,8,9,7,19,11,8,1,10,22,26
80,16/10/04,Birmingham,Man United,0,0,D,8,7,9,-2,13,8,2,9,7,7
81,16/10/04,Blackburn,Middlesbrough,0,4,A,8,12,14,-7,11,8,0,12,6,7
82,16/10/04,Bolton,Crystal Palace,1,0,H,8,14,11,2,5,8,-6,8,12,13
83,16/10/04,Everton,Southampton,1,0,H,8,11,7,2,5,8,-5,6,16,9
84,16/10/04,Fulham,Liverpool,2,4,A,7,6,13,-5,10,8,4,10,8,8
85,16/10/04,Man City,Chelsea,1,0,H,8,1,7,1,20,8,7,8,8,8
86,16/10/04,West Brom,Norwich,0,0,D,8,14,13,-5,5,8,-7,7,7,8
87,17/10/04,Charlton,Newcastle,1,1,D,8,13,14,-6,12,8,3,16,11,8
88,18/10/04,Portsmouth,Tottenham,1,0,H,8,3,11,0,13,7,2,5,8,11
89,23/10/04,Aston Villa,Fulham,2,0,H,9,17,12,-1,8,9,-7,10,11,11
90,23/10/04,Chelsea,Blackburn,4,0,H,9,18,2,6,6,9,-11,7,20,8
91,23/10/04,Crystal Palace,West Brom,3,0,H,9,13,15,-7,8,9,-5,8,5,8
92,23/10/04,Liverpool,Charlton,2,0,H,9,15,8,6,12,8,-6,9,13,14
93,23/10/04,Norwich,Everton,2,3,A,9,7,14,-7,19,9,3,10,6,7
94,23/10/04,Tottenham,Bolton,1,2,A,9,11,4,1,15,9,3,14,13,5
95,24/10/04,Man United,Arsenal,2,0,H,9,8,7,2,25,9,21,29,14,9
96,24/10/04,Middlesbrough,Portsmouth,1,1,D,8,11,12,4,11,9,1,12,14,16
97,24/10/04,Newcastle,Man City,4,3,H,9,7,14,3,11,9,2,9,13,17
98,24/10/04,Southampton,Birmingham,0,0,D,9,9,12,-6,8,9,-2,7,5,6
99,30/10/04,Arsenal,Southampton,2,2,D,10,12,10,19,6,10,-6,6,25,29
100,30/10/04,Birmingham,Crystal Palace,0,1,A,10,15,9,-2,8,10,-4,11,9,7
101,30/10/04,Blackburn,Liverpool,2,2,D,9,8,22,-15,16,10,8,16,6,7
102,30/10/04,Charlton,Middlesbrough,1,2,A,10,13,17,-8,15,10,4,17,12,9
103,30/10/04,Everton,Aston Villa,1,1,D,10,12,9,4,14,10,1,13,22,13
104,30/10/04,Fulham,Tottenham,2,0,H,10,6,19,-9,13,10,0,6,8,10
105,30/10/04,Portsmouth,Man United,2,0,H,10,7,12,1,17,9,4,11,12,13
106,30/10/04,West Brom,Chelsea,1,4,A,10,2,16,-8,23,10,10,12,8,8
107,31/10/04,Bolton,Newcastle,2,1,H,10,17,12,4,16,10,4,21,18,16
108,01/11/04,Man City,Norwich,1,1,D,10,17,11,1,6,10,-8,9,11,12
109,06/11/04,Aston Villa,Portsmouth,3,0,H,10,12,13,1,15,11,3,15,15,14
110,06/11/04,Chelsea,Everton,1,0,H,11,10,3,13,23,11,4,14,26,16
111,06/11/04,Crystal Palace,Arsenal,1,1,D,11,12,15,-3,26,11,19,31,11,12
112,06/11/04,Liverpool,Birmingham,0,1,A,11,10,10,8,9,10,-3,7,17,18
113,06/11/04,Norwich,Blackburn,1,1,D,11,24,18,-8,7,11,-15,9,7,10
114,06/11/04,Southampton,West Brom,2,2,D,11,20,14,-6,8,11,-11,9,7,8
115,06/11/04,Tottenham,Charlton,2,3,A,11,19,8,-2,12,11,-9,10,13,6
116,07/11/04,Man United,Man City,0,0,D,11,12,9,2,12,11,1,13,17,11
117,07/11/04,Middlesbrough,Bolton,1,1,D,11,13,14,5,21,11,5,18,18,19
118,07/11/04,Newcastle,Fulham,1,4,A,11,19,19,3,11,11,-7,12,16,22
119,13/11/04,Birmingham,Everton,0,1,A,12,11,10,-2,23,12,3,14,12,8
120,13/11/04,Bolton,Aston Villa,1,2,A,12,13,14,5,18,12,4,17,22,19
121,13/11/04,Charlton,Norwich,4,0,H,12,19,21,-8,8,12,-8,11,15,13
122,13/11/04,Fulham,Chelsea,1,4,A,12,3,20,-4,29,12,14,17,14,16
123,13/11/04,Liverpool,Crystal Palace,3,2,H,12,16,11,7,12,11,-3,13,17,18
124,13/11/04,Man City,Blackburn,1,1,D,12,25,12,1,8,12,-15,10,13,13
125,13/11/04,Southampton,Portsmouth,2,1,H,11,15,16,-6,15,12,0,15,8,10
126,13/11/04,Tottenham,Arsenal,4,5,A,12,13,11,-3,27,12,19,32,13,8
127,14/11/04,Newcastle,Man United,1,3,A,12,9,23,0,18,12,2,11,16,23
128,14/11/04,West Brom,Middlesbrough,1,2,A,12,15,22,-11,19,12,5,20,9,11
129,20/11/04,Arsenal,West Brom,1,1,D,13,24,17,20,9,13,-12,12,30,37
130,20/11/04,Chelsea,Bolton,2,2,D,13,16,4,17,22,13,4,20,32,21
131,20/11/04,Crystal Palace,Newcastle,0,2,A,13,26,19,-4,16,13,-2,24,12,15
132,20/11/04,Everton,Fulham,1,0,H,13,24,11,4,14,13,-7,17,26,15
133,20/11/04,Man United,Charlton,2,0,H,13,21,10,4,18,13,-4,17,21,14
134,20/11/04,Middlesbrough,Liverpool,2,0,H,12,13,16,6,20,13,8,21,22,22
135,20/11/04,Norwich,Southampton,2,1,H,13,17,23,-12,11,13,-5,12,8,11
136,20/11/04,Portsmouth,Man City,1,3,A,13,13,17,-1,14,12,1,14,15,16
137,21/11/04,Blackburn,Birmingham,3,3,D,13,11,26,-15,12,13,-3,8,9,11
138,22/11/04,Aston Villa,Tottenham,1,0,H,13,16,14,5,13,13,-4,12,21,19
139,27/11/04,Birmingham,Norwich,1,1,D,14,24,14,-3,11,14,-11,13,13,11
140,27/11/04,Bolton,Portsmouth,0,1,A,13,20,18,4,15,14,-3,17,23,22
141,27/11/04,Charlton,Chelsea,0,4,A,14,6,23,-6,33,14,17,23,18,17
142,27/11/04,Fulham,Blackburn,0,2,A,14,29,25,-8,10,14,-15,14,14,17
143,27/11/04,Man City,Aston Villa,2,0,H,14,14,14,3,24,14,6,20,17,17
144,27/11/04,Southampton,Crystal Palace,2,2,D,14,21,19,-6,12,14,-6,15,11,13
145,27/11/04,West Brom,Man United,0,3,A,14,10,25,-12,24,14,6,16,10,13
146,28/11/04,Liverpool,Arsenal,2,1,H,14,18,15,6,31,13,20,38,20,21
147,28/11/04,Newcastle,Everton,1,1,D,14,11,26,0,29,14,5,16,19,26
148,28/11/04,Tottenham,Middlesbrough,2,0,H,14,16,17,-5,25,14,8,24,13,12
149,04/12/04,Arsenal,Birmingham,3,0,H,15,15,20,19,14,15,-3,12,31,39
150,04/12/04,Aston Villa,Liverpool,1,1,D,14,16,16,4,23,15,7,23,24,20
151,04/12/04,Blackburn,Tottenham,0,1,A,15,17,29,-13,16,15,-3,14,13,16
152,04/12/04,Chelsea,Newcastle,4,0,H,15,27,6,21,20,15,0,27,36,27
153,04/12/04,Everton,Bolton,3,2,H,15,19,12,5,23,15,3,22,30,17
154,04/12/04,Man United,Southampton,3,0,H,15,21,10,9,12,15,-6,15,27,19
155,04/12/04,Norwich,Fulham,0,1,A,15,27,25,-11,14,15,-10,17,12,14
156,04/12/04,Portsmouth,West Brom,3,2,H,15,28,20,-2,10,14,-15,13,18,18
157,05/12/04,Crystal Palace,Charlton,0,1,A,15,27,23,-6,18,15,-10,17,13,17
158,06/12/04,Middlesbrough,Man City,3,2,H,15,14,18,6,20,15,5,19,25,24
159,11/12/04,Crystal Palace,Blackburn,0,0,D,16,30,24,-7,13,16,-14,16,13,17
160,11/12/04,Everton,Liverpool,1,0,H,15,17,14,6,24,16,7,24,33,20
161,11/12/04,Man City,Tottenham,0,1,A,16,17,17,4,19,16,-2,15,20,21
162,11/12/04,Newcastle,Portsmouth,1,1,D,15,22,31,-4,21,16,-1,21,20,27
163,11/12/04,Norwich,Bolton,3,2,H,16,22,26,-12,23,16,2,24,12,14
164,11/12/04,Southampton,Middlesbrough,2,2,D,16,20,24,-9,28,16,7,27,12,15
165,11/12/04,West Brom,Charlton,0,1,A,16,27,31,-16,21,16,-9,18,10,15
166,12/12/04,Arsenal,Chelsea,2,2,D,16,6,20,22,39,16,25,31,34,42
167,12/12/04,Aston Villa,Birmingham,1,2,A,16,18,17,4,14,16,-6,12,25,21
168,13/12/04,Fulham,Man United,1,1,D,16,10,27,-9,30,16,12,22,17,18
169,14/12/04,Liverpool,Portsmouth,1,1,D,16,23,18,6,22,16,-1,22,24,24
170,18/12/04,Birmingham,West Brom,4,0,H,17,32,19,-5,10,17,-17,15,17,14
171,18/12/04,Blackburn,Everton,0,0,D,17,14,30,-14,36,17,7,21,14,16
172,18/12/04,Bolton,Man City,0,1,A,17,18,25,1,20,17,3,21,23,26
173,18/12/04,Chelsea,Norwich,4,0,H,17,28,8,25,15,17,-11,17,40,33
174,18/12/04,Man United,Crystal Palace,5,2,H,17,24,11,12,14,17,-7,17,31,23
175,18/12/04,Middlesbrough,Aston Villa,3,0,H,17,19,22,7,25,17,3,22,29,29
176,18/12/04,Tottenham,Southampton,5,1,H,17,26,17,-1,13,17,-9,17,22,16
177,19/12/04,Liverpool,Newcastle,3,1,H,17,32,19,6,21,17,-4,28,25,25
178,19/12/04,Portsmouth,Arsenal,0,1,A,17,22,24,-1,35,17,22,44,23,23
179,20/12/04,Charlton,Fulham,2,1,H,17,28,27,-8,18,17,-9,19,24,19
180,26/12/04,Arsenal,Fulham,2,0,H,18,30,22,23,18,18,-10,20,38,45
181,26/12/04,Birmingham,Middlesbrough,2,0,H,18,22,19,-1,32,18,10,32,20,18
182,26/12/04,Blackburn,Newcastle,2,2,D,18,35,30,-14,21,18,-6,29,15,16
183,26/12/04,Chelsea,Aston Villa,1,0,H,18,22,8,29,25,18,0,22,43,37
184,26/12/04,Crystal Palace,Portsmouth,0,1,A,18,25,29,-10,23,18,-2,23,14,19
185,26/12/04,Everton,Man City,2,1,H,18,18,14,7,23,18,4,22,37,21
186,26/12/04,Man United,Bolton,2,0,H,18,26,13,15,23,18,0,26,34,28
187,26/12/04,Norwich,Tottenham,0,2,A,18,18,32,-15,25,18,3,21,15,17
188,26/12/04,Southampton,Charlton,0,0,D,18,28,31,-13,27,18,-7,21,13,18
189,26/12/04,West Brom,Liverpool,0,5,A,18,20,36,-21,28,18,8,28,10,15
190,28/12/04,Aston Villa,Man United,0,1,A,19,13,23,-1,37,19,17,30,25,22
191,28/12/04,Bolton,Blackburn,0,1,A,19,32,28,-2,16,19,-14,18,23,26
192,28/12/04,Charlton,Everton,2,0,H,19,15,28,-7,40,19,8,23,28,21
193,28/12/04,Fulham,Birmingham,2,3,A,19,19,32,-12,23,19,1,20,18,20
194,28/12/04,Liverpool,Southampton,1,0,H,19,31,20,13,14,19,-13,18,31,33
195,28/12/04,Man City,West Brom,1,1,D,19,41,20,3,10,19,-26,15,23,23
196,28/12/04,Middlesbrough,Norwich,2,0,H,19,34,24,8,15,19,-17,17,32,32
197,28/12/04,Portsmouth,Chelsea,0,2,A,19,8,25,-1,46,19,30,38,26,24
198,28/12/04,Tottenham,Crystal Palace,1,1,D,19,30,18,5,14,19,-11,19,28,23
199,29/12/04,Newcastle,Arsenal,0,1,A,19,22,37,-6,41,19,25,47,22,31
200,01/01/05,Aston Villa,Blackburn,1,0,H,20,32,24,-2,19,20,-13,19,25,22
201,01/01/05,Bolton,West Brom,1,1,D,20,42,29,-3,11,20,-26,16,23,26
202,01/01/05,Charlton,Arsenal,1,3,A,20,22,28,-5,44,20,26,48,31,23
203,01/01/05,Fulham,Crystal Palace,3,1,H,20,31,35,-13,15,20,-11,20,18,22
204,01/01/05,Liverpool,Chelsea,0,1,A,20,8,20,14,49,20,32,40,34,34
205,01/01/05,Man City,Southampton,2,1,H,20,32,21,3,14,20,-14,18,24,24
206,01/01/05,Middlesbrough,Man United,0,2,A,20,13,24,10,40,20,18,31,35,34
207,01/01/05,Newcastle,Birmingham,2,1,H,20,21,38,-7,26,20,2,23,22,31
208,01/01/05,Portsmouth,Norwich,1,1,D,20,36,27,-3,15,20,-19,17,26,24
209,01/01/05,Tottenham,Everton,5,2,H,20,17,19,5,40,20,6,23,29,24
210,03/01/05,Blackburn,Charlton,1,0,H,21,31,33,-14,31,21,-7,24,19,19
211,03/01/05,Crystal Palace,Aston Villa,2,0,H,21,24,34,-13,28,21,-1,23,15,21
212,03/01/05,Norwich,Liverpool,1,2,A,21,21,37,-19,34,21,13,34,16,18
213,03/01/05,West Brom,Newcastle,0,0,D,21,39,43,-26,25,21,-6,33,12,17
214,04/01/05,Arsenal,Man City,1,1,D,21,22,23,28,27,21,4,26,47,51
215,04/01/05,Birmingham,Bolton,1,2,A,21,30,23,1,24,21,-3,27,26,24
216,04/01/05,Chelsea,Middlesbrough,2,0,H,21,26,8,33,35,21,8,34,52,41
217,04/01/05,Everton,Portsmouth,2,1,H,21,28,22,3,27,21,-3,25,40,25
218,04/01/05,Man United,Tottenham,0,0,D,21,21,13,20,32,21,8,29,43,33
219,05/01/05,Southampton,Fulham,3,3,D,21,36,34,-15,21,21,-11,25,14,19
220,15/01/05,Aston Villa,Norwich,3,0,H,22,39,26,-3,16,22,-20,19,28,23
221,15/01/05,Bolton,Arsenal,1,0,H,22,24,31,-2,48,22,28,52,27,29
222,15/01/05,Charlton,Birmingham,3,1,H,22,25,32,-8,26,22,0,25,31,24
223,15/01/05,Liverpool,Man United,0,1,A,22,13,22,14,44,22,20,33,37,36
224,15/01/05,Man City,Crystal Palace,3,1,H,22,34,23,4,18,22,-11,23,28,27
225,15/01/05,Newcastle,Southampton,2,1,H,22,37,39,-6,15,22,-15,22,26,33
226,15/01/05,Portsmouth,Blackburn,0,1,A,22,33,30,-4,22,22,-13,20,27,26
227,15/01/05,Tottenham,Chelsea,0,2,A,22,8,21,8,55,22,35,43,33,29
228,16/01/05,Fulham,West Brom,1,0,H,22,43,39,-11,13,22,-26,17,22,28
229,16/01/05,Middlesbrough,Everton,1,1,D,22,23,28,6,43,22,4,27,35,34
230,22/01/05,Birmingham,Fulham,1,2,A,23,39,28,-2,25,23,-10,29,26,26
231,22/01/05,Chelsea,Portsmouth,3,0,H,23,31,8,37,27,23,-5,26,58,45
232,22/01/05,Crystal Palace,Tottenham,3,0,H,23,23,37,-13,33,23,6,29,18,24
233,22/01/05,Everton,Charlton,0,1,A,23,33,24,4,34,23,-6,27,44,28
234,22/01/05,Man United,Aston Villa,3,1,H,23,26,13,21,31,23,0,26,47,34
235,22/01/05,Norwich,Middlesbrough,4,4,D,23,29,42,-23,36,23,6,35,16,19
236,22/01/05,Southampton,Liverpool,2,0,H,23,23,39,-16,37,23,13,36,15,23
237,22/01/05,West Brom,Man City,2,0,H,23,24,44,-27,31,23,6,30,13,17
238,23/01/05,Arsenal,Newcastle,1,0,H,23,40,25,27,29,23,-5,35,48,52
239,24/01/05,Blackburn,Bolton,0,1,A,23,31,33,-12,30,23,-1,30,25,21
240,01/02/05,Arsenal,Man United,2,4,A,24,14,25,28,50,24,23,37,51,53
241,01/02/05,Bolton,Tottenham,3,1,H,24,26,31,0,33,24,3,29,33,31
242,01/02/05,Charlton,Liverpool,1,2,A,24,25,33,-5,37,24,11,36,37,28
243,01/02/05,Portsmouth,Middlesbrough,2,1,H,24,33,34,-8,37,24,6,39,27,26
244,01/02/05,West Brom,Crystal Palace,2,2,D,24,37,44,-25,21,24,-10,27,16,19
245,02/02/05,Birmingham,Southampton,2,1,H,24,39,30,-3,18,24,-14,25,26,27
246,02/02/05,Blackburn,Chelsea,0,1,A,24,8,34,-13,61,24,40,48,25,21
247,02/02/05,Everton,Norwich,1,0,H,24,46,25,3,17,24,-23,23,44,28
248,02/02/05,Fulham,Aston Villa,1,1,D,24,29,40,-9,31,24,-2,27,28,31
249,02/02/05,Man City,Newcastle,1,1,D,24,41,26,4,29,24,-6,35,31,30
250,05/02/05,Aston Villa,Arsenal,1,3,A,25,29,30,-2,51,25,26,55,32,28
251,05/02/05,Crystal Palace,Bolton,0,1,A,25,32,39,-10,36,25,2,34,22,29
252,05/02/05,Liverpool,Fulham,3,1,H,25,41,26,12,29,25,-9,32,40,38
253,05/02/05,Man United,Birmingham,2,0,H,25,31,16,25,29,25,-2,29,53,41
254,05/02/05,Middlesbrough,Blackburn,1,0,H,25,35,35,5,25,25,-14,21,37,40
255,05/02/05,Newcastle,Charlton,1,1,D,25,35,42,-6,37,25,-6,29,30,36
256,05/02/05,Norwich,West Brom,3,2,H,25,46,47,-24,17,25,-25,21,17,23
257,05/02/05,Tottenham,Portsmouth,3,1,H,25,35,29,1,30,25,-7,28,33,30
258,06/02/05,Chelsea,Man City,0,0,D,25,27,8,41,32,25,4,31,64,49
259,06/02/05,Southampton,Everton,2,2,D,25,25,41,-15,47,25,4,29,18,26
260,12/02/05,Birmingham,Liverpool,2,0,H,26,27,33,-4,43,26,14,41,29,29
261,12/02/05,Blackburn,Norwich,3,0,H,26,49,36,-15,20,26,-23,26,25,21
262,12/02/05,Bolton,Middlesbrough,0,0,D,26,35,32,3,40,26,6,41,39,35
263,12/02/05,Everton,Chelsea,0,1,A,26,8,27,4,65,26,41,49,48,31
264,12/02/05,Portsmouth,Aston Villa,1,2,A,26,33,38,-9,32,26,-4,29,30,29
265,13/02/05,Man City,Man United,0,2,A,26,16,27,4,56,26,27,43,33,31
266,14/02/05,Arsenal,Crystal Palace,5,1,H,26,40,30,28,22,26,-11,29,54,58
267,22/02/05,West Brom,Southampton,0,0,D,26,43,49,-26,19,26,-15,28,17,23
268,26/02/05,Aston Villa,Everton,1,3,A,27,28,34,-3,48,27,3,31,35,31
269,26/02/05,Crystal Palace,Birmingham,2,0,H,27,33,45,-15,32,27,-2,31,22,30
270,26/02/05,Man United,Portsmouth,2,1,H,27,40,16,29,30,27,-10,30,59,45
271,26/02/05,Southampton,Arsenal,1,1,D,27,31,43,-15,57,27,32,63,20,28
272,26/02/05,Tottenham,Fulham,2,0,H,26,44,30,3,29,26,-11,33,36,33
273,27/02/05,Middlesbrough,Charlton,2,2,D,26,36,35,6,38,27,-6,30,41,41
274,27/02/05,Newcastle,Bolton,2,1,H,27,32,43,-6,40,26,3,35,31,37
275,28/02/05,Norwich,Man City,2,3,A,27,29,52,-26,33,27,2,31,20,26
276,05/03/05,Arsenal,Portsmouth,3,0,H,28,42,32,32,30,28,-11,31,58,64
277,05/03/05,Aston Villa,Middlesbrough,2,0,H,28,37,37,-5,42,28,6,43,35,32
278,05/03/05,Crystal Palace,Man United,0,0,D,28,17,45,-13,62,28,30,47,25,32
279,05/03/05,Fulham,Charlton,0,0,D,27,38,46,-13,39,27,-6,32,29,33
280,05/03/05,Newcastle,Liverpool,1,0,H,27,29,44,-5,43,27,12,41,34,39
281,05/03/05,Norwich,Chelsea,1,3,A,27,8,55,-27,68,28,42,50,20,28
282,05/03/05,Southampton,Tottenham,1,0,H,27,30,44,-15,39,28,5,35,21,29
283,06/03/05,Everton,Blackburn,0,1,A,27,36,29,5,28,28,-12,24,51,34
284,06/03/05,West Brom,Birmingham,2,0,H,28,35,49,-26,32,27,-4,31,18,23
285,07/03/05,Man City,Bolton,0,1,A,28,34,31,3,40,28,2,36,36,34
286,15/03/05,Chelsea,West Brom,1,0,H,28,49,9,44,21,28,-24,25,71,53
287,16/03/05,Charlton,Tottenham,2,0,H,28,31,38,-6,39,28,4,35,40,32
288,16/03/05,Liverpool,Blackburn,0,0,D,28,36,30,11,31,28,-11,25,43,41
289,19/03/05,Blackburn,Arsenal,0,1,A,29,32,36,-11,61,29,35,67,32,25
290,19/03/05,Bolton,Norwich,1,0,H,29,58,34,3,20,29,-29,29,43,37
291,19/03/05,Charlton,West Brom,1,4,A,29,50,38,-4,21,29,-25,25,43,34
292,19/03/05,Chelsea,Crystal Palace,4,1,H,29,45,9,45,26,29,-13,32,74,54
293,19/03/05,Man United,Fulham,1,0,H,28,46,17,30,30,29,-13,33,63,47
294,19/03/05,Portsmouth,Newcastle,1,1,D,28,44,45,-14,37,29,-4,40,30,31
295,19/03/05,Tottenham,Man City,2,1,H,29,32,33,2,36,29,2,34,39,35
296,20/03/05,Birmingham,Aston Villa,2,0,H,29,37,37,-6,38,29,-3,34,32,31
297,20/03/05,Liverpool,Everton,2,1,H,29,30,30,11,51,29,4,34,44,41
298,20/03/05,Middlesbrough,Southampton,1,3,A,29,44,39,4,24,29,-14,30,42,43
299,02/04/05,Arsenal,Norwich,4,1,H,30,59,32,36,20,30,-30,29,64,68
300,02/04/05,Birmingham,Tottenham,1,1,D,30,34,37,-4,42,30,3,37,35,33
301,02/04/05,Charlton,Man City,2,2,D,30,34,42,-7,36,30,1,35,43,35
302,02/04/05,Crystal Palace,Middlesbrough,0,1,A,30,42,49,-16,42,30,2,44,26,33
303,02/04/05,Liverpool,Bolton,1,0,H,30,34,31,12,46,30,4,38,47,43
304,02/04/05,Man United,Blackburn,0,0,D,30,37,17,31,32,30,-12,25,66,48
305,02/04/05,Newcastle,Aston Villa,0,3,A,30,39,45,-4,38,29,-5,34,38,41
306,02/04/05,Southampton,Chelsea,1,3,A,30,10,45,-12,77,30,48,58,27,33
307,03/04/05,Fulham,Portsmouth,3,1,H,30,46,47,-14,31,29,-14,32,30,33
308,03/04/05,West Brom,Everton,1,0,H,30,32,51,-22,51,30,3,35,24,29
309,09/04/05,Blackburn,Southampton,3,0,H,31,48,37,-12,27,31,-14,34,33,25
310,09/04/05,Bolton,Fulham,3,1,H,30,48,35,3,33,31,-12,36,46,38
311,09/04/05,Chelsea,Birmingham,1,1,D,31,38,11,50,36,31,-4,34,80,61
312,09/04/05,Man City,Liverpool,1,0,H,31,31,36,1,50,31,13,44,37,37
313,09/04/05,Middlesbrough,Arsenal,0,1,A,31,33,42,3,67,31,39,72,45,45
314,09/04/05,Norwich,Man United,2,0,H,31,17,63,-33,67,31,31,48,20,30
315,09/04/05,Portsmouth,Charlton,4,2,H,31,44,49,-16,44,31,-7,37,31,33
316,10/04/05,Aston Villa,West Brom,1,1,D,31,51,39,-2,27,31,-21,30,41,37
317,10/04/05,Everton,Crystal Palace,4,0,H,31,50,33,2,26,31,-17,33,51,35
318,10/04/05,Tottenham,Newcastle,1,0,H,30,48,35,3,38,31,-7,41,43,38
319,16/04/05,Birmingham,Portsmouth,0,0,D,32,51,39,-4,34,32,-14,37,37,35
320,16/04/05,Charlton,Bolton,1,2,A,32,36,48,-9,49,32,5,41,44,39
321,16/04/05,Crystal Palace,Norwich,3,3,D,32,63,54,-21,23,32,-31,32,26,33
322,16/04/05,Fulham,Man City,1,1,D,32,36,51,-14,40,31,2,38,33,37
323,16/04/05,Liverpool,Tottenham,2,2,D,32,35,32,12,46,32,4,39,50,44
324,16/04/05,Southampton,Aston Villa,2,3,A,32,40,51,-17,42,32,-2,38,27,34
325,19/04/05,Bolton,Southampton,1,1,D,33,54,37,6,27,33,-18,36,52,43
326,19/04/05,Middlesbrough,Fulham,1,1,D,32,52,43,2,34,32,-14,38,45,45
327,20/04/05,Aston Villa,Charlton,0,0,D,33,50,42,-1,44,33,-10,40,45,41
328,20/04/05,Blackburn,Crystal Palace,1,0,H,33,57,37,-9,27,32,-21,36,36,28
329,20/04/05,Chelsea,Arsenal,0,0,D,32,33,12,50,70,32,40,73,81,62
330,20/04/05,Everton,Man United,1,0,H,32,19,33,6,67,32,29,48,54,39
331,20/04/05,Man City,Birmingham,3,0,H,33,39,37,2,38,33,-4,35,41,39
332,20/04/05,Norwich,Newcastle,2,1,H,31,49,66,-31,38,33,-8,41,24,35
333,20/04/05,Portsmouth,Liverpool,1,2,A,33,34,51,-14,51,33,12,46,35,37
334,20/04/05,Tottenham,West Brom,1,1,D,32,52,37,4,28,33,-21,31,47,41
