MatchID,Date,HomeTeam,AwayTeam,FTHG,FTAG,FTR,HomeOVA,AwayOVA,AT_match_played,AT_goal_against,HT_goal_against,HT_goal_differnece,AT_current_standing,HT_match_played,AT_goal_differnece,AT_goal_for,HT_current_standing,HT_goal_for
0,19/08/06,Arsenal,Aston Villa,1,1,D,82,75,0,0,0,0,0,0,0,0,0,0
1,19/08/06,Bolton,Tottenham,2,0,H,76,79,0,0,0,0,0,0,0,0,0,0
2,19/08/06,Everton,Watford,2,1,H,77,68,0,0,0,0,0,0,0,0,0,0
3,19/08/06,Newcastle,Wigan,2,1,H,79,74,0,0,0,0,0,0,0,0,0,0
4,19/08/06,Portsmouth,Blackburn,3,0,H,75,77,0,0,0,0,0,0,0,0,0,0
5,19/08/06,Reading,Middlesbrough,3,2,H,71,76,0,0,0,0,0,0,0,0,0,0
6,19/08/06,Sheffield United,Liverpool,1,1,D,72,81,0,0,0,0,0,0,0,0,0,0
7,19/08/06,West Ham,Charlton,3,1,H,76,75,0,0,0,0,0,0,0,0,0,0
8,20/08/06,Chelsea,Man City,3,0,H,84,77,0,0,0,0,0,0,0,0,0,0
9,20/08/06,Man United,Fulham,5,1,H,82,75,0,0,0,0,0,0,0,0,0,0
10,22/08/06,Tottenham,Sheffield United,2,0,H,79,72,1,1,2,-2,1,1,0,1,0,0
11,22/08/06,Watford,West Ham,1,1,D,68,76,1,1,2,-1,3,1,2,3,0,1
12,23/08/06,Aston Villa,Reading,2,1,H,75,71,1,2,1,0,3,1,1,3,1,1
13,23/08/06,Blackburn,Everton,1,1,D,77,77,1,1,3,-3,3,1,1,2,0,0
14,23/08/06,Charlton,Man United,0,3,A,75,82,1,1,3,-2,3,1,4,5,0,1
15,23/08/06,Fulham,Bolton,1,1,D,75,76,1,0,5,-4,3,1,2,2,0,1
16,23/08/06,Man City,Portsmouth,0,0,D,77,75,1,0,3,-3,3,1,3,3,0,0
17,23/08/06,Middlesbrough,Chelsea,2,1,H,76,84,1,0,3,-1,3,1,3,3,0,2
18,26/08/06,Charlton,Bolton,2,0,H,75,76,2,1,6,-5,4,2,2,3,0,1
19,26/08/06,Fulham,Sheffield United,1,0,H,75,72,2,3,6,-4,1,2,-2,1,1,2
20,26/08/06,Liverpool,West Ham,2,1,H,81,76,2,2,1,0,4,1,2,4,1,1
21,26/08/06,Man City,Arsenal,1,0,H,77,82,1,1,3,-3,1,2,0,1,1,0
22,26/08/06,Tottenham,Everton,0,2,A,79,77,2,2,2,0,4,2,1,3,3,2
23,26/08/06,Watford,Man United,1,2,A,68,82,2,1,3,-1,6,2,7,8,1,2
24,26/08/06,Wigan,Reading,1,0,H,74,71,2,4,2,-1,3,1,0,4,0,1
25,27/08/06,Aston Villa,Newcastle,2,0,H,75,79,1,1,2,1,3,2,1,2,4,3
26,27/08/06,Blackburn,Chelsea,0,2,A,77,84,2,2,4,-3,3,2,2,4,1,1
27,28/08/06,Middlesbrough,Portsmouth,0,4,A,76,75,2,0,4,0,4,2,3,3,3,4
28,09/09/06,Arsenal,Middlesbrough,1,1,D,82,76,3,8,2,-1,3,2,-4,4,1,1
29,09/09/06,Bolton,Watford,1,0,H,76,68,3,5,3,0,1,3,-2,3,4,3
30,09/09/06,Chelsea,Charlton,2,1,H,84,75,3,6,2,4,3,3,-3,3,6,6
31,09/09/06,Everton,Liverpool,3,0,H,77,81,2,2,2,3,4,3,1,3,7,5
32,09/09/06,Man United,Tottenham,1,0,H,82,79,3,4,2,8,3,3,-2,2,9,10
33,09/09/06,Newcastle,Fulham,1,2,A,79,75,3,6,3,-1,4,2,-3,3,3,2
34,09/09/06,Portsmouth,Wigan,1,0,H,75,74,2,2,0,7,3,3,0,2,7,7
35,09/09/06,Sheffield United,Blackburn,0,0,D,72,77,3,6,4,-3,1,3,-5,1,1,1
36,10/09/06,West Ham,Aston Villa,1,1,D,76,75,3,2,4,1,7,3,3,5,4,5
37,11/09/06,Reading,Man City,1,0,H,71,77,3,3,5,-1,4,3,-2,1,3,4
38,16/09/06,Bolton,Middlesbrough,0,0,D,76,76,4,9,3,1,4,4,-4,5,7,4
39,16/09/06,Charlton,Portsmouth,0,1,A,75,75,4,0,8,-4,10,4,8,8,3,4
40,16/09/06,Everton,Wigan,2,2,D,77,74,3,3,2,6,3,4,-1,2,10,8
41,16/09/06,Sheffield United,Reading,1,2,A,72,71,4,5,4,-3,6,4,0,5,2,1
42,16/09/06,Watford,Aston Villa,0,0,D,68,75,4,3,6,-3,8,4,3,6,1,3
43,17/09/06,Blackburn,Man City,4,2,H,77,77,4,4,6,-5,4,4,-3,1,2,1
44,17/09/06,Chelsea,Liverpool,1,0,H,84,81,3,5,3,5,4,4,-2,3,9,8
45,17/09/06,Man United,Arsenal,0,1,A,82,82,3,3,2,9,2,4,-1,2,12,11
46,17/09/06,Tottenham,Fulham,0,0,D,79,75,4,7,5,-3,7,4,-2,5,3,2
47,17/09/06,West Ham,Newcastle,0,2,A,76,79,3,5,5,1,3,4,-2,3,5,6
48,20/09/06,Liverpool,Newcastle,2,0,H,81,79,4,5,6,-3,6,4,0,5,4,3
49,23/09/06,Arsenal,Sheffield United,3,0,H,82,72,5,6,3,0,2,4,-4,2,5,3
50,23/09/06,Aston Villa,Charlton,2,0,H,75,75,5,9,3,3,3,5,-5,4,9,6
51,23/09/06,Fulham,Chelsea,0,2,A,75,84,5,3,7,-2,12,5,6,9,8,5
52,23/09/06,Liverpool,Tottenham,3,0,H,81,79,5,5,6,-1,4,5,-3,2,7,5
53,23/09/06,Man City,West Ham,2,0,H,77,76,5,7,8,-5,5,5,-1,6,4,3
54,23/09/06,Middlesbrough,Blackburn,0,1,A,76,77,5,8,9,-4,5,5,-3,5,5,5
55,23/09/06,Reading,Man United,1,1,D,71,82,5,3,6,1,12,5,8,11,9,7
56,23/09/06,Wigan,Watford,1,1,D,74,68,5,6,5,-1,2,4,-3,3,4,4
57,24/09/06,Newcastle,Everton,1,1,D,79,77,5,4,7,-2,11,5,6,10,6,5
58,25/09/06,Portsmouth,Bolton,0,1,A,75,76,5,3,0,9,8,5,1,4,13,9
59,30/09/06,Bolton,Liverpool,2,0,H,76,81,6,6,3,2,10,6,2,8,11,5
60,30/09/06,Charlton,Arsenal,1,2,A,75,82,5,3,11,-7,8,6,3,6,3,4
61,30/09/06,Chelsea,Aston Villa,1,1,D,84,75,6,3,3,8,12,6,5,8,15,11
62,30/09/06,Everton,Man City,1,1,D,77,77,6,8,5,6,7,6,-3,5,12,11
63,30/09/06,Sheffield United,Middlesbrough,2,1,H,72,76,6,10,9,-7,5,6,-5,5,2,2
64,01/10/06,Blackburn,Wigan,2,1,H,77,74,5,6,8,-2,5,6,-1,5,8,6
65,01/10/06,Man United,Newcastle,2,0,H,82,79,6,8,4,8,7,6,-2,6,13,12
66,01/10/06,Tottenham,Portsmouth,2,1,H,79,75,6,1,8,-6,13,6,8,9,4,2
67,01/10/06,West Ham,Reading,0,1,A,76,71,6,7,9,-3,10,6,1,8,5,6
68,02/10/06,Watford,Fulham,3,3,D,68,75,6,9,7,-3,8,6,-4,5,3,4
69,14/10/06,Arsenal,Watford,3,0,H,82,68,7,10,4,4,4,6,-3,7,11,8
70,14/10/06,Aston Villa,Tottenham,1,1,D,75,79,7,9,4,5,7,7,-5,4,13,9
71,14/10/06,Liverpool,Blackburn,1,1,D,81,77,7,9,8,0,11,7,-1,8,10,8
72,14/10/06,Man City,Sheffield United,0,0,D,77,72,7,10,9,-3,5,7,-6,4,8,6
73,14/10/06,Middlesbrough,Everton,2,1,H,76,77,7,6,12,-6,13,7,6,12,5,6
74,14/10/06,Portsmouth,West Ham,2,0,H,75,76,7,10,3,7,5,7,-4,6,13,10
75,14/10/06,Reading,Chelsea,0,1,A,71,84,7,4,7,2,16,7,8,12,13,9
76,14/10/06,Wigan,Man United,1,3,A,74,82,7,4,8,-2,16,6,10,14,5,6
77,15/10/06,Newcastle,Bolton,1,2,A,79,76,7,3,10,-4,14,7,4,7,7,6
78,16/10/06,Fulham,Charlton,2,1,H,75,75,7,13,12,-4,3,7,-8,5,9,8
79,21/10/06,Aston Villa,Fulham,1,1,D,75,75,8,13,5,5,12,8,-3,10,14,10
80,21/10/06,Charlton,Watford,0,0,D,75,68,8,13,15,-9,4,8,-6,7,3,6
81,21/10/06,Chelsea,Portsmouth,2,1,H,84,75,8,3,4,9,16,8,9,12,19,13
82,21/10/06,Everton,Sheffield United,2,0,H,77,72,8,10,8,5,6,8,-6,4,13,13
83,21/10/06,Wigan,Man City,4,0,H,74,77,8,9,11,-4,9,7,-3,6,5,7
84,22/10/06,Blackburn,Bolton,0,1,A,77,76,8,4,10,-1,17,8,5,9,12,9
85,22/10/06,Man United,Liverpool,2,0,H,82,81,8,9,5,12,11,8,0,9,19,17
86,22/10/06,Middlesbrough,Newcastle,1,0,H,76,79,8,12,13,-5,7,8,-5,7,8,8
87,22/10/06,Reading,Arsenal,0,4,A,71,82,7,4,8,1,14,8,7,11,13,9
88,22/10/06,Tottenham,West Ham,1,0,H,79,76,8,12,10,-5,5,8,-6,6,8,5
89,28/10/06,Arsenal,Everton,1,1,D,82,77,9,8,4,11,16,8,7,15,17,15
90,28/10/06,Bolton,Man United,0,4,A,76,82,9,5,4,6,22,9,14,19,20,10
91,28/10/06,Fulham,Wigan,0,1,A,75,74,8,11,14,-3,8,9,0,11,13,11
92,28/10/06,Liverpool,Aston Villa,3,1,H,81,75,9,6,11,-2,15,9,5,11,11,9
93,28/10/06,Newcastle,Charlton,0,0,D,79,75,9,15,13,-6,4,9,-9,6,7,7
94,28/10/06,Portsmouth,Reading,3,1,H,75,71,9,12,5,8,13,9,-3,9,16,13
95,28/10/06,Sheffield United,Chelsea,0,2,A,72,84,9,5,12,-8,22,9,10,15,6,4
96,28/10/06,Watford,Tottenham,0,0,D,68,79,9,10,13,-6,11,9,-4,6,5,7
97,29/10/06,West Ham,Blackburn,2,1,H,76,77,9,11,13,-7,12,9,-2,9,5,6
98,30/10/06,Man City,Middlesbrough,1,0,H,77,76,9,13,13,-7,11,9,-4,9,9,6
99,04/11/06,Bolton,Wigan,0,1,A,76,74,9,11,8,2,11,10,1,12,20,10
100,04/11/06,Charlton,Man City,1,0,H,75,77,10,13,15,-9,12,10,-6,7,5,6
101,04/11/06,Fulham,Everton,1,0,H,75,77,10,9,15,-4,17,10,7,16,13,11
102,04/11/06,Liverpool,Reading,2,0,H,81,71,10,15,12,0,13,10,-5,10,14,12
103,04/11/06,Man United,Portsmouth,3,0,H,82,75,10,6,5,18,19,10,10,16,25,23
104,04/11/06,Newcastle,Sheffield United,0,1,A,79,72,10,14,13,-6,6,10,-10,4,8,7
105,04/11/06,Watford,Middlesbrough,2,0,H,68,76,10,14,13,-6,11,10,-5,9,6,7
106,05/11/06,Aston Villa,Blackburn,2,0,H,75,77,10,13,9,3,12,10,-3,10,15,12
107,05/11/06,Tottenham,Chelsea,2,1,H,79,84,10,5,10,-4,25,10,12,17,12,6
108,05/11/06,West Ham,Arsenal,1,0,H,76,82,9,5,14,-6,18,10,11,16,8,8
109,11/11/06,Blackburn,Man United,0,1,A,77,82,11,5,15,-5,28,11,21,26,12,10
110,11/11/06,Chelsea,Watford,4,0,H,84,68,11,13,7,11,9,11,-4,9,25,18
111,11/11/06,Everton,Aston Villa,0,1,A,77,75,11,9,10,6,18,11,5,14,17,16
112,11/11/06,Man City,Newcastle,0,0,D,77,79,11,14,14,-7,8,11,-7,7,12,7
113,11/11/06,Middlesbrough,West Ham,1,0,H,76,76,11,14,16,-7,11,11,-5,9,11,9
114,11/11/06,Portsmouth,Fulham,1,1,D,75,75,11,15,9,7,16,11,-3,12,19,16
115,11/11/06,Sheffield United,Bolton,2,2,D,72,76,11,9,14,-9,20,11,1,10,9,5
116,11/11/06,Wigan,Charlton,3,2,H,74,75,11,15,11,2,8,10,-8,7,14,13
117,12/11/06,Arsenal,Liverpool,3,0,H,82,81,11,12,6,10,17,10,2,14,18,16
118,12/11/06,Reading,Tottenham,3,1,H,71,79,11,11,17,-7,15,11,-3,8,13,10
119,18/11/06,Arsenal,Newcastle,1,1,D,82,79,12,14,6,13,9,11,-7,7,21,19
120,18/11/06,Chelsea,West Ham,1,0,H,84,76,12,15,7,15,11,12,-6,9,28,22
121,18/11/06,Everton,Bolton,1,0,H,77,76,12,11,11,5,21,12,1,12,17,16
122,18/11/06,Man City,Fulham,3,1,H,77,75,12,16,14,-7,17,12,-3,13,13,7
123,18/11/06,Middlesbrough,Liverpool,0,0,D,76,81,12,15,16,-6,17,12,-1,14,14,10
124,18/11/06,Portsmouth,Watford,2,1,H,75,68,12,17,10,7,9,12,-8,9,20,17
125,18/11/06,Reading,Charlton,2,0,H,71,75,12,18,18,-5,8,12,-9,9,16,13
126,18/11/06,Sheffield United,Man United,1,2,A,72,82,12,5,16,-9,31,12,22,27,10,7
127,19/11/06,Blackburn,Tottenham,1,1,D,77,79,12,14,16,-6,15,12,-5,9,12,10
128,19/11/06,Wigan,Aston Villa,0,0,D,74,75,12,9,13,3,21,11,6,15,17,16
129,25/11/06,Aston Villa,Middlesbrough,1,1,D,75,76,13,16,9,6,15,13,-6,10,22,15
130,25/11/06,Bolton,Arsenal,3,1,H,76,82,12,7,12,0,22,13,13,20,21,12
131,25/11/06,Charlton,Everton,1,1,D,75,77,13,11,20,-11,20,13,6,17,8,9
132,25/11/06,Fulham,Reading,0,1,A,75,71,13,18,19,-5,19,13,-3,15,17,14
133,25/11/06,Liverpool,Man City,1,0,H,81,77,13,15,15,-1,16,13,-5,10,18,14
134,25/11/06,West Ham,Sheffield United,1,0,H,76,72,13,18,16,-7,10,13,-10,8,11,9
135,26/11/06,Man United,Chelsea,1,1,D,82,84,13,7,6,23,31,13,16,23,34,29
136,26/11/06,Newcastle,Portsmouth,1,0,H,79,75,13,11,15,-7,23,13,8,19,10,8
137,26/11/06,Tottenham,Wigan,3,1,H,79,74,12,13,15,-5,18,13,3,16,16,10
138,28/11/06,Watford,Sheffield United,0,1,A,68,72,14,19,19,-9,10,13,-11,8,9,10
139,29/11/06,Aston Villa,Man City,1,3,A,75,77,14,16,10,6,16,14,-6,10,23,16
140,29/11/06,Bolton,Chelsea,0,1,A,76,84,14,8,13,2,32,14,16,24,24,15
141,29/11/06,Fulham,Arsenal,2,1,H,75,82,13,10,20,-6,22,14,11,21,17,14
142,29/11/06,Liverpool,Portsmouth,0,0,D,81,75,14,12,15,0,23,14,7,19,21,15
143,29/11/06,Man United,Everton,3,0,H,82,77,14,12,7,23,21,14,6,18,35,30
144,02/12/06,Arsenal,Tottenham,3,0,H,82,79,14,16,12,10,19,14,-3,13,22,22
145,02/12/06,Blackburn,Fulham,2,0,H,77,75,15,21,17,-6,20,13,-5,16,13,11
146,02/12/06,Middlesbrough,Man United,1,2,A,76,82,15,7,17,-6,38,14,26,33,16,11
147,02/12/06,Portsmouth,Aston Villa,2,2,D,75,75,15,13,12,7,23,15,4,17,24,19
148,02/12/06,Reading,Bolton,1,0,H,71,76,15,14,18,-2,24,14,1,15,22,16
149,02/12/06,Sheffield United,Charlton,2,1,H,72,75,14,21,19,-10,9,15,-11,10,13,9
150,02/12/06,Wigan,Liverpool,0,4,A,74,81,15,15,16,1,22,13,0,15,18,17
151,03/12/06,Everton,West Ham,2,0,H,77,76,14,16,15,3,14,15,-6,10,21,18
152,04/12/06,Man City,Watford,0,0,D,77,68,14,20,17,-4,9,15,-10,10,19,13
153,05/12/06,Charlton,Blackburn,1,0,H,75,77,14,17,23,-12,16,15,-4,13,9,11
154,05/12/06,Tottenham,Middlesbrough,2,1,H,79,76,15,19,19,-6,16,15,-7,12,19,13
155,06/12/06,Newcastle,Reading,3,2,H,79,71,15,18,15,-6,25,14,-1,17,13,9
156,06/12/06,West Ham,Wigan,0,2,A,76,74,14,20,18,-8,18,15,-3,17,14,10
157,09/12/06,Blackburn,Newcastle,1,3,A,77,79,15,17,18,-5,16,15,-5,12,16,13
158,09/12/06,Bolton,West Ham,4,0,H,76,76,16,20,15,0,14,16,-10,10,24,15
159,09/12/06,Liverpool,Fulham,4,0,H,81,75,16,23,15,4,20,16,-7,16,25,19
160,09/12/06,Man United,Man City,3,1,H,82,77,16,17,8,27,20,16,-4,13,41,35
161,09/12/06,Middlesbrough,Wigan,1,1,D,76,74,15,20,21,-8,21,16,-1,19,16,13
162,09/12/06,Portsmouth,Everton,2,0,H,75,77,16,15,14,7,24,16,5,20,25,21
163,09/12/06,Tottenham,Charlton,5,1,H,79,75,16,23,20,-5,12,16,-11,12,22,15
164,09/12/06,Watford,Reading,0,0,D,68,71,16,21,20,-10,25,15,-2,19,10,10
165,10/12/06,Chelsea,Arsenal,1,1,D,84,82,15,12,8,17,25,15,13,25,35,25
166,11/12/06,Sheffield United,Aston Villa,2,2,D,72,75,16,15,20,-9,24,16,4,19,16,11
167,13/12/06,Chelsea,Newcastle,1,0,H,84,79,16,18,9,17,19,16,-3,15,36,26
168,13/12/06,Wigan,Arsenal,0,1,A,74,82,16,13,21,-1,26,16,13,26,22,20
169,16/12/06,Arsenal,Portsmouth,2,2,D,82,75,17,14,13,14,28,17,9,23,29,27
170,16/12/06,Aston Villa,Bolton,0,1,A,75,76,17,15,17,4,27,17,4,19,25,21
171,16/12/06,Charlton,Liverpool,0,3,A,75,81,17,15,28,-15,28,17,8,23,12,13
172,16/12/06,Newcastle,Watford,2,1,H,79,68,16,20,19,-4,11,17,-10,10,19,15
173,16/12/06,Reading,Blackburn,1,2,A,71,77,16,21,21,-2,16,17,-7,14,26,19
174,16/12/06,Wigan,Sheffield United,0,1,A,74,72,17,22,22,-2,17,17,-9,13,22,20
175,17/12/06,Everton,Chelsea,2,3,A,77,84,17,9,17,3,39,17,18,27,24,20
176,17/12/06,Man City,Tottenham,1,2,A,77,79,17,21,20,-6,25,17,-1,20,20,14
177,17/12/06,West Ham,Man United,1,0,H,76,82,17,9,24,-14,44,17,29,38,14,10
178,18/12/06,Fulham,Middlesbrough,2,1,H,75,76,17,22,27,-11,17,17,-8,14,20,16
179,23/12/06,Arsenal,Blackburn,6,2,H,82,77,17,22,15,14,19,18,-6,16,30,29
180,23/12/06,Aston Villa,Man United,0,3,A,75,82,18,10,18,3,44,18,28,38,25,21
181,23/12/06,Fulham,West Ham,0,0,D,75,76,18,24,28,-10,17,18,-13,11,23,18
182,23/12/06,Liverpool,Watford,2,0,H,81,68,17,22,15,11,11,18,-11,11,31,26
183,23/12/06,Man City,Bolton,0,2,A,77,76,18,15,22,-7,30,18,5,20,20,15
184,23/12/06,Middlesbrough,Charlton,2,0,H,76,75,18,31,24,-9,12,18,-18,13,17,15
185,23/12/06,Newcastle,Tottenham,3,1,H,79,79,18,22,20,-3,28,18,0,22,22,17
186,23/12/06,Portsmouth,Sheffield United,3,1,H,75,72,18,22,16,9,20,18,-8,14,29,25
187,23/12/06,Reading,Everton,0,2,A,71,77,18,20,23,-3,24,18,2,22,26,20
188,23/12/06,Wigan,Chelsea,2,3,A,74,84,18,11,23,-3,42,18,19,30,22,20
189,26/12/06,Blackburn,Liverpool,1,0,H,77,81,19,15,28,-10,34,18,13,28,19,18
190,26/12/06,Bolton,Newcastle,2,1,H,76,79,19,21,15,7,25,19,-1,20,33,22
191,26/12/06,Chelsea,Reading,2,2,D,84,71,19,25,13,20,26,19,-5,20,45,33
192,26/12/06,Everton,Middlesbrough,0,0,D,77,76,19,24,20,4,20,19,-7,17,27,24
193,26/12/06,Man United,Wigan,3,1,H,82,74,19,26,10,31,22,19,-4,22,47,41
194,26/12/06,Sheffield United,Man City,0,1,A,72,77,19,24,25,-10,20,19,-9,15,20,15
195,26/12/06,Tottenham,Aston Villa,2,1,H,79,75,19,21,25,-2,25,19,0,21,28,23
196,26/12/06,Watford,Arsenal,1,2,A,68,82,19,17,24,-13,33,18,18,35,11,11
197,26/12/06,West Ham,Portsmouth,1,2,A,76,75,19,17,24,-13,32,19,11,28,18,11
198,27/12/06,Charlton,Fulham,2,2,D,75,75,19,28,33,-20,24,19,-10,18,12,13
199,30/12/06,Blackburn,Middlesbrough,2,1,H,77,76,20,24,28,-9,21,19,-7,17,22,19
200,30/12/06,Bolton,Portsmouth,3,2,H,76,75,20,18,16,8,35,20,12,30,36,24
201,30/12/06,Charlton,Aston Villa,2,1,H,75,75,20,23,35,-20,25,20,-1,22,13,15
202,30/12/06,Chelsea,Fulham,2,2,D,84,75,20,30,15,20,25,20,-10,20,46,35
203,30/12/06,Everton,Newcastle,3,0,H,77,79,20,23,20,4,25,20,-2,21,28,24
204,30/12/06,Man United,Reading,3,2,H,82,71,20,27,11,33,27,20,-5,22,50,44
205,30/12/06,Sheffield United,Arsenal,1,0,H,72,82,20,18,26,-11,36,20,19,37,20,15
206,30/12/06,Tottenham,Liverpool,0,1,A,79,81,20,16,26,-1,34,20,12,28,31,25
207,30/12/06,West Ham,Man City,0,1,A,76,77,20,24,26,-14,23,20,-8,16,18,12
208,01/01/07,Fulham,Watford,0,0,D,75,68,19,26,32,-10,11,21,-14,12,26,22
209,01/01/07,Liverpool,Bolton,3,0,H,81,76,21,18,16,13,39,21,9,27,37,29
210,01/01/07,Man City,Everton,2,1,H,77,77,21,20,24,-7,31,21,7,27,26,17
211,01/01/07,Middlesbrough,Sheffield United,3,1,H,76,72,21,26,26,-8,23,21,-10,16,21,18
212,01/01/07,Newcastle,Man United,2,2,D,79,82,21,13,26,-5,53,21,34,47,25,21
213,01/01/07,Portsmouth,Tottenham,1,1,D,75,79,21,27,21,11,31,21,-2,25,35,32
214,01/01/07,Reading,West Ham,6,0,H,71,76,21,27,30,-6,18,21,-15,12,27,24
215,01/01/07,Wigan,Blackburn,0,3,A,74,77,20,29,29,-6,25,20,-8,21,22,23
216,02/01/07,Arsenal,Charlton,4,0,H,82,75,21,36,19,18,16,21,-19,17,36,37
217,02/01/07,Aston Villa,Chelsea,0,0,D,75,84,21,17,25,-2,47,21,20,37,25,23
218,13/01/07,Blackburn,Arsenal,0,2,A,77,82,22,19,29,-5,39,21,22,41,28,24
219,13/01/07,Bolton,Man City,0,0,D,76,77,22,25,21,6,29,22,-6,19,39,27
220,13/01/07,Charlton,Middlesbrough,1,3,A,75,76,22,27,40,-23,24,22,-6,21,16,17
221,13/01/07,Chelsea,Wigan,4,0,H,84,74,21,32,17,20,22,22,-9,23,48,37
222,13/01/07,Man United,Aston Villa,3,1,H,82,75,22,25,15,34,26,22,-2,23,54,49
223,13/01/07,Sheffield United,Portsmouth,1,1,D,72,75,22,22,29,-12,36,22,11,33,23,17
224,13/01/07,Watford,Liverpool,0,3,A,68,81,22,16,26,-14,40,20,16,32,12,12
225,13/01/07,West Ham,Fulham,3,3,D,76,75,22,32,33,-21,27,22,-10,22,18,12
226,14/01/07,Everton,Reading,1,1,D,77,71,22,30,22,6,30,22,0,30,31,28
227,14/01/07,Tottenham,Newcastle,2,3,A,79,79,22,28,28,-2,26,22,-5,23,32,26
228,20/01/07,Aston Villa,Watford,2,0,H,75,68,21,29,28,-4,12,23,-17,12,26,24
229,20/01/07,Fulham,Tottenham,1,1,D,75,79,23,31,35,-10,32,23,-3,28,28,25
230,20/01/07,Liverpool,Chelsea,2,0,H,81,84,23,17,16,19,51,23,24,41,43,35
231,20/01/07,Man City,Blackburn,0,3,A,77,77,22,31,25,-6,28,23,-7,24,30,19
232,20/01/07,Middlesbrough,Bolton,5,1,H,76,76,23,21,28,-4,40,23,6,27,27,24
233,20/01/07,Newcastle,West Ham,2,2,D,79,76,23,36,30,-4,19,23,-21,15,29,26
234,20/01/07,Portsmouth,Charlton,0,1,A,75,75,23,43,23,11,16,23,-25,18,37,34
235,20/01/07,Reading,Sheffield United,3,1,H,71,72,23,30,31,0,24,23,-12,18,31,31
236,21/01/07,Arsenal,Man United,2,1,H,82,82,23,16,19,24,57,23,36,52,42,43
237,21/01/07,Wigan,Everton,0,2,A,74,77,23,23,36,-13,32,22,6,29,22,23
238,23/01/07,Watford,Blackburn,2,1,H,68,77,23,31,31,-19,31,22,-4,27,12,12
239,30/01/07,Portsmouth,Middlesbrough,0,0,D,75,76,24,29,24,10,30,24,0,29,37,34
240,30/01/07,Reading,Wigan,3,2,H,71,74,23,38,32,2,22,24,-15,23,34,34
241,30/01/07,Sheffield United,Fulham,2,0,H,72,75,24,36,33,-14,29,24,-10,26,24,19
242,30/01/07,West Ham,Liverpool,1,2,A,76,81,24,16,38,-21,46,24,21,37,20,17
243,31/01/07,Bolton,Charlton,1,1,D,76,75,24,43,26,2,19,24,-24,19,40,28
244,31/01/07,Chelsea,Blackburn,3,0,H,84,77,24,33,19,22,31,24,-5,28,51,41
245,31/01/07,Man United,Watford,4,0,H,82,68,23,32,18,35,15,24,-18,14,57,53
246,31/01/07,Newcastle,Aston Villa,3,1,H,79,75,24,28,32,-4,29,24,-2,26,30,28
247,03/02/07,Aston Villa,West Ham,1,0,H,75,76,25,40,31,-4,20,25,-22,18,29,27
248,03/02/07,Blackburn,Sheffield United,2,1,H,77,72,25,33,36,-8,27,25,-12,21,31,28
249,03/02/07,Charlton,Chelsea,0,1,A,75,84,25,19,44,-24,54,25,25,44,20,20
250,03/02/07,Fulham,Newcastle,2,1,H,75,79,25,33,38,-12,33,25,-2,31,29,26
251,03/02/07,Liverpool,Everton,0,0,D,81,77,24,23,17,22,35,25,8,31,49,39
252,03/02/07,Man City,Reading,0,2,A,77,71,25,34,28,-9,37,24,3,37,30,19
253,03/02/07,Middlesbrough,Arsenal,1,1,D,76,82,24,20,29,0,45,25,25,45,31,29
254,03/02/07,Watford,Bolton,0,1,A,68,76,25,27,36,-22,41,24,2,29,15,14
255,03/02/07,Wigan,Portsmouth,1,0,H,74,75,25,24,41,-16,38,24,10,34,22,25
256,04/02/07,Tottenham,Man United,0,4,A,79,82,25,18,32,-3,60,24,39,57,33,29
257,10/02/07,Chelsea,Middlesbrough,3,0,H,84,76,26,30,19,26,32,26,0,30,57,45
258,10/02/07,Everton,Blackburn,1,0,H,77,77,26,37,23,8,34,25,-7,30,36,31
259,10/02/07,Man United,Charlton,2,0,H,82,75,26,45,18,43,20,26,-25,20,63,61
260,10/02/07,Newcastle,Liverpool,2,1,H,79,81,26,17,35,-3,50,26,22,39,33,32
261,10/02/07,Portsmouth,Man City,2,1,H,75,77,25,30,25,9,30,26,-11,19,38,34
262,10/02/07,Reading,Aston Villa,2,0,H,71,75,26,31,34,5,32,26,-3,28,40,39
263,10/02/07,Sheffield United,Tottenham,2,1,H,72,79,25,36,35,-13,33,26,-7,29,27,22
264,10/02/07,West Ham,Watford,0,1,A,76,68,25,37,41,-23,15,26,-23,14,20,18
265,11/02/07,Arsenal,Wigan,2,1,H,82,74,25,41,21,25,25,25,-15,26,46,46
266,11/02/07,Bolton,Fulham,2,1,H,76,75,26,39,27,3,32,26,-11,28,44,30
267,21/02/07,Everton,Tottenham,1,2,A,77,79,26,38,23,9,33,26,-8,30,39,32
268,21/02/07,Watford,Wigan,1,1,D,68,74,26,43,37,-22,25,26,-16,27,18,15
269,24/02/07,Charlton,West Ham,4,0,H,75,76,27,42,47,-27,20,27,-24,18,20,20
270,24/02/07,Fulham,Man United,1,2,A,75,82,27,18,41,-12,66,27,45,63,32,29
271,24/02/07,Liverpool,Sheffield United,4,0,H,81,72,27,36,19,21,30,27,-12,24,50,40
272,24/02/07,Middlesbrough,Reading,2,1,H,76,71,27,34,33,-3,43,27,7,41,32,30
273,24/02/07,Watford,Everton,0,3,A,68,77,27,25,38,-22,39,27,8,33,19,16
274,25/02/07,Blackburn,Portsmouth,3,0,H,77,75,27,26,38,-8,41,27,10,36,34,30
275,25/02/07,Tottenham,Bolton,4,1,H,79,76,27,28,39,-7,47,27,4,32,36,32
276,25/02/07,Wigan,Newcastle,1,0,H,74,79,27,36,44,-16,36,27,-2,34,26,28
277,03/03/07,Arsenal,Reading,2,1,H,82,71,28,36,22,26,43,26,6,42,49,48
278,03/03/07,Fulham,Aston Villa,1,1,D,75,75,27,33,43,-13,32,28,-5,28,32,30
279,03/03/07,Liverpool,Man United,0,1,A,81,82,28,19,19,25,69,28,46,65,53,44
280,03/03/07,Man City,Wigan,0,1,A,77,74,28,44,32,-12,29,26,-15,29,30,20
281,03/03/07,Newcastle,Middlesbrough,0,0,D,79,76,28,34,37,-3,35,28,-2,32,36,34
282,03/03/07,Portsmouth,Chelsea,0,2,A,75,84,27,19,29,7,60,28,29,48,41,36
283,03/03/07,Sheffield United,Everton,1,1,D,72,77,28,25,40,-16,42,28,11,36,30,24
284,03/03/07,Watford,Charlton,2,2,D,68,75,28,47,41,-25,23,28,-23,24,19,16
285,04/03/07,Bolton,Blackburn,1,2,A,76,77,28,38,32,1,37,28,-5,33,47,33
286,04/03/07,West Ham,Tottenham,3,4,A,76,79,28,40,46,-28,39,28,-4,36,20,18
287,14/03/07,Aston Villa,Arsenal,0,1,A,75,82,27,23,34,-5,52,28,27,50,33,29
288,14/03/07,Man City,Chelsea,0,1,A,77,84,28,19,33,-13,63,27,31,50,30,20
289,17/03/07,Blackburn,West Ham,1,2,A,77,76,29,50,39,-4,20,29,-29,21,40,35
290,17/03/07,Chelsea,Sheffield United,3,0,H,84,72,29,41,19,32,31,29,-16,25,66,51
291,17/03/07,Man United,Bolton,4,1,H,82,76,29,34,19,47,47,29,0,34,72,66
292,17/03/07,Middlesbrough,Man City,0,2,A,76,77,28,34,34,-2,30,29,-14,20,36,32
293,17/03/07,Reading,Portsmouth,0,0,D,71,75,29,31,38,5,41,29,5,36,43,43
294,17/03/07,Tottenham,Watford,3,1,H,79,68,29,43,43,-3,20,29,-25,18,42,40
295,17/03/07,Wigan,Fulham,0,0,D,74,75,29,44,44,-14,33,29,-13,31,32,30
296,18/03/07,Aston Villa,Liverpool,0,0,D,75,81,29,20,35,-6,53,29,24,44,33,29
297,18/03/07,Charlton,Newcastle,2,0,H,75,79,29,37,49,-23,37,29,-3,34,24,26
298,18/03/07,Everton,Arsenal,1,0,H,77,82,28,23,26,11,55,29,28,51,43,37
299,31/03/07,Bolton,Sheffield United,1,0,H,76,72,30,44,38,-3,31,30,-19,25,47,35
300,31/03/07,Charlton,Wigan,1,0,H,75,74,30,44,49,-21,33,30,-14,30,27,28
301,31/03/07,Fulham,Portsmouth,1,1,D,75,75,30,31,44,-13,42,30,5,36,34,31
302,31/03/07,Liverpool,Arsenal,4,1,H,81,82,29,24,20,24,55,30,27,51,54,44
303,31/03/07,Man United,Blackburn,4,1,H,82,77,30,41,20,50,40,30,-5,36,75,70
304,31/03/07,Newcastle,Man City,0,1,A,79,77,29,34,39,-5,33,30,-12,22,37,34
305,31/03/07,Watford,Chelsea,0,1,A,68,84,30,19,46,-27,69,30,35,54,20,19
306,31/03/07,West Ham,Middlesbrough,2,0,H,76,76,30,36,51,-28,36,30,-4,32,23,23
307,01/04/07,Tottenham,Reading,1,0,H,79,71,30,38,44,-1,44,30,5,43,45,43
308,02/04/07,Aston Villa,Everton,1,1,D,75,77,30,26,35,-6,46,30,12,38,34,29
309,06/04/07,Everton,Fulham,4,1,H,77,75,31,45,27,12,35,31,-13,32,47,39
310,06/04/07,Man City,Charlton,0,0,D,77,75,31,49,34,-11,30,30,-20,29,36,23
311,07/04/07,Arsenal,West Ham,0,1,A,82,76,31,51,28,24,26,30,-26,25,55,52
312,07/04/07,Blackburn,Aston Villa,1,2,A,77,75,31,36,45,-8,35,31,-6,30,40,37
313,07/04/07,Chelsea,Tottenham,1,0,H,84,79,31,44,19,36,48,31,0,44,72,55
314,07/04/07,Middlesbrough,Watford,4,1,H,76,68,31,47,38,-6,20,31,-28,19,36,32
315,07/04/07,Portsmouth,Man United,2,1,H,75,82,31,21,32,5,78,31,53,74,43,37
316,07/04/07,Reading,Liverpool,1,2,A,71,81,31,21,39,4,57,31,27,48,44,43
317,07/04/07,Sheffield United,Newcastle,1,2,A,72,79,31,40,45,-20,37,31,-6,34,31,25
318,07/04/07,Wigan,Bolton,1,3,A,74,76,31,38,45,-15,50,31,-2,36,33,30
319,09/04/07,Aston Villa,Wigan,1,1,D,75,74,32,48,37,-5,33,32,-17,31,38,32
320,09/04/07,Bolton,Everton,1,1,D,76,77,32,28,39,0,50,32,15,43,53,39
321,09/04/07,Charlton,Reading,0,0,D,75,71,32,41,49,-20,44,32,3,44,31,29
322,09/04/07,Fulham,Man City,1,3,A,75,77,31,34,49,-16,37,32,-11,23,35,33
323,09/04/07,Newcastle,Arsenal,0,0,D,79,82,31,29,41,-5,55,32,23,52,40,36
324,09/04/07,Watford,Portsmouth,4,2,H,68,75,32,33,51,-31,46,32,6,39,20,20
325,14/04/07,Arsenal,Bolton,2,1,H,82,76,33,40,29,23,54,32,0,40,56,52
326,14/04/07,Man City,Liverpool,0,0,D,77,81,32,22,35,-9,60,32,28,50,40,26
327,14/04/07,Middlesbrough,Aston Villa,1,3,A,76,75,33,38,39,-3,39,32,-5,33,39,36
328,14/04/07,Portsmouth,Newcastle,2,1,H,75,79,33,41,37,4,41,33,-5,36,46,41
329,14/04/07,Reading,Fulham,1,0,H,71,75,33,52,41,3,35,33,-18,34,45,44
330,14/04/07,Sheffield United,West Ham,3,0,H,72,76,32,51,47,-21,29,32,-25,26,31,26
331,15/04/07,Everton,Charlton,2,1,H,77,75,33,49,29,15,32,33,-20,29,51,44
332,15/04/07,Wigan,Tottenham,3,3,D,74,79,32,45,49,-17,48,33,-1,44,34,32
333,17/04/07,Arsenal,Man City,3,1,H,82,77,33,35,30,24,41,33,-9,26,59,54
334,17/04/07,Man United,Sheffield United,2,0,H,82,72,33,47,23,52,34,32,-18,29,78,75
335,18/04/07,Blackburn,Watford,3,1,H,77,68,33,53,47,-9,23,32,-29,24,40,38
336,18/04/07,Liverpool,Middlesbrough,2,0,H,81,76,33,42,22,28,39,33,-5,37,61,50
337,18/04/07,West Ham,Chelsea,1,4,A,76,84,32,19,54,-28,75,33,37,56,29,26
338,21/04/07,Bolton,Reading,1,3,A,76,71,34,41,42,-1,48,34,4,45,54,41
339,21/04/07,Charlton,Sheffield United,1,1,D,75,72,34,49,51,-21,34,34,-20,29,32,30
340,21/04/07,Fulham,Blackburn,1,1,D,75,77,33,48,53,-19,43,34,-7,41,35,34
341,21/04/07,Liverpool,Wigan,2,0,H,81,74,34,52,22,30,35,34,-17,35,64,52
342,21/04/07,Man United,Middlesbrough,1,1,D,82,76,34,44,23,54,39,33,-7,37,81,77
343,21/04/07,Tottenham,Arsenal,2,2,D,79,82,34,31,48,-1,62,33,26,57,49,47
344,21/04/07,Watford,Man City,1,1,D,68,77,34,38,56,-31,41,34,-11,27,23,25
345,21/04/07,West Ham,Everton,1,0,H,76,77,34,30,58,-31,54,34,16,46,29,27
346,22/04/07,Aston Villa,Portsmouth,0,0,D,75,75,34,38,39,-3,49,34,5,43,42,36
347,22/04/07,Newcastle,Chelsea,0,0,D,79,84,33,20,43,-6,78,34,40,60,41,37
348,28/04/07,Blackburn,Charlton,4,1,H,77,75,35,52,49,-7,33,34,-21,31,44,42
349,28/04/07,Chelsea,Bolton,2,2,D,84,76,35,45,20,40,54,34,-3,42,79,60
350,28/04/07,Everton,Man United,2,4,A,77,82,34,24,31,15,82,35,54,78,54,46
351,28/04/07,Man City,Aston Villa,0,2,A,77,75,35,39,39,-11,43,35,-3,36,42,28
352,28/04/07,Middlesbrough,Tottenham,2,3,A,76,79,34,50,45,-7,50,35,-1,49,40,38
353,28/04/07,Portsmouth,Liverpool,2,1,H,75,81,35,22,38,5,67,35,32,54,50,43
354,28/04/07,Sheffield United,Watford,1,0,H,72,68,35,57,50,-20,24,35,-31,26,35,30
355,28/04/07,Wigan,West Ham,0,3,A,74,76,35,58,54,-19,32,35,-30,28,35,35
356,29/04/07,Arsenal,Fulham,3,1,H,82,75,35,54,33,26,36,35,-19,35,63,59
357,30/04/07,Reading,Newcastle,1,0,H,71,79,35,43,42,6,42,35,-6,37,51,48
358,05/05/07,Aston Villa,Sheffield United,3,0,H,75,72,36,50,39,-1,38,36,-19,31,46,38
359,05/05/07,Everton,Portsmouth,3,0,H,77,75,36,39,35,13,53,36,6,45,54,48
360,05/05/07,Fulham,Liverpool,1,0,H,75,81,36,24,57,-21,67,36,31,55,36,36
361,05/05/07,Man City,Man United,0,1,A,77,82,35,26,41,-13,85,36,56,82,42,28
362,05/05/07,Newcastle,Blackburn,0,2,A,79,77,35,50,44,-7,47,36,-4,46,42,37
363,05/05/07,Reading,Watford,0,2,A,71,68,36,58,42,7,24,36,-32,26,54,49
364,05/05/07,West Ham,Bolton,3,1,H,76,76,36,47,58,-27,55,36,-3,44,35,31
365,05/05/07,Wigan,Middlesbrough,0,1,A,74,76,36,48,57,-22,40,36,-8,40,35,35
366,06/05/07,Arsenal,Chelsea,1,1,D,82,84,35,22,34,28,80,36,40,62,66,62
367,07/05/07,Charlton,Tottenham,0,2,A,75,79,35,52,56,-24,53,36,0,52,33,32
368,09/05/07,Chelsea,Man United,0,0,D,84,82,36,26,23,40,88,36,57,83,81,63
369,10/05/07,Tottenham,Blackburn,1,1,D,79,77,36,50,52,2,50,36,-2,48,56,54
370,13/05/07,Blackburn,Reading,3,3,D,77,71,37,44,51,-2,54,37,5,49,51,49
371,13/05/07,Bolton,Aston Villa,2,2,D,76,75,37,39,50,-5,49,37,2,41,55,45
372,13/05/07,Chelsea,Everton,1,1,D,84,77,37,35,23,40,57,37,16,51,82,63
373,13/05/07,Liverpool,Charlton,2,2,D,81,75,37,58,25,30,33,37,-26,32,67,55
374,13/05/07,Man United,West Ham,0,1,A,82,76,37,59,26,57,38,37,-25,34,89,83
375,13/05/07,Middlesbrough,Fulham,3,1,H,76,75,37,57,48,-7,39,37,-20,37,43,41
376,13/05/07,Portsmouth,Arsenal,0,0,D,75,82,37,35,42,3,67,37,28,63,53,45
377,13/05/07,Sheffield United,Wigan,1,2,A,72,74,37,58,53,-22,35,37,-23,35,38,31
378,13/05/07,Tottenham,Man City,2,1,H,79,77,37,42,53,2,42,37,-14,28,57,55
379,13/05/07,Watford,Newcastle,1,1,D,68,79,37,46,58,-30,42,37,-9,37,27,28
