MatchID,Date,HomeTeam,AwayTeam,FTHG,FTAG,FTR,HomeOVA,AwayOVA,AT_match_played,AT_goal_against,HT_goal_against,HT_goal_differnece,AT_current_standing,HT_match_played,AT_goal_differnece,AT_goal_for,HT_current_standing,HT_goal_for
0,18/08/12,Arsenal,Sunderland,0,0,D,80,75,0,0,0,0,0,0,0,0,0,0
1,18/08/12,Fulham,Norwich,5,0,H,77,73,0,0,0,0,0,0,0,0,0,0
2,18/08/12,Newcastle,Tottenham,2,1,H,77,80,0,0,0,0,0,0,0,0,0,0
3,18/08/12,QPR,Swansea,0,5,A,75,74,0,0,0,0,0,0,0,0,0,0
4,18/08/12,Reading,Stoke,1,1,D,71,75,0,0,0,0,0,0,0,0,0,0
5,18/08/12,West Brom,Liverpool,3,0,H,74,79,0,0,0,0,0,0,0,0,0,0
6,18/08/12,West Ham,Aston Villa,1,0,H,74,75,0,0,0,0,0,0,0,0,0,0
7,19/08/12,Man City,Southampton,3,2,H,82,73,0,0,0,0,0,0,0,0,0,0
8,19/08/12,Wigan,Chelsea,0,2,A,74,81,0,0,0,0,0,0,0,0,0,0
9,20/08/12,Everton,Man United,1,0,H,76,82,0,0,0,0,0,0,0,0,0,0
10,22/08/12,Chelsea,Reading,4,2,H,81,71,1,1,0,2,1,1,0,1,3,2
11,25/08/12,Aston Villa,Everton,1,3,A,75,76,1,0,1,-1,3,1,1,1,0,0
12,25/08/12,Chelsea,Newcastle,2,0,H,81,77,1,1,2,4,3,2,1,2,6,6
13,25/08/12,Man United,Fulham,3,2,H,82,77,1,0,1,-1,3,1,5,5,0,0
14,25/08/12,Norwich,QPR,1,1,D,73,75,1,5,5,-5,0,1,-5,0,0,0
15,25/08/12,Southampton,Wigan,0,2,A,73,74,1,2,3,-1,0,1,-2,0,0,2
16,25/08/12,Swansea,West Ham,3,0,H,74,74,1,0,0,5,3,1,1,1,3,5
17,25/08/12,Tottenham,West Brom,1,1,D,80,74,1,0,2,-1,3,1,3,3,0,1
18,26/08/12,Liverpool,Man City,2,2,D,79,82,1,2,3,-3,3,1,1,3,0,0
19,26/08/12,Stoke,Arsenal,0,0,D,75,80,1,0,1,0,1,1,0,0,1,1
20,01/09/12,Man City,QPR,3,1,H,82,75,2,6,4,1,1,2,-5,1,4,5
21,01/09/12,Swansea,Sunderland,2,2,D,74,75,1,0,0,8,1,2,0,0,6,8
22,01/09/12,Tottenham,Norwich,1,1,D,80,73,2,6,3,-1,1,2,-5,1,1,2
23,01/09/12,West Brom,Everton,2,0,H,74,76,2,1,1,3,6,2,3,4,4,4
24,01/09/12,West Ham,Fulham,3,0,H,74,77,2,3,3,-2,3,2,4,7,3,1
25,01/09/12,Wigan,Stoke,2,2,D,74,75,2,1,2,0,2,2,0,1,3,2
26,02/09/12,Liverpool,Arsenal,0,2,A,79,80,2,0,5,-3,2,2,0,0,1,2
27,02/09/12,Newcastle,Aston Villa,1,1,D,77,75,2,4,3,-1,0,2,-3,1,3,2
28,02/09/12,Southampton,Man United,2,3,A,73,82,2,3,5,-3,3,2,0,3,0,2
29,15/09/12,Arsenal,Southampton,6,1,H,80,73,3,8,0,2,0,3,-4,4,5,2
30,15/09/12,Aston Villa,Swansea,2,0,H,75,74,3,2,5,-3,7,3,8,10,1,2
31,15/09/12,Fulham,West Brom,3,0,H,77,74,3,1,6,1,7,3,5,6,3,7
32,15/09/12,Man United,Wigan,4,0,H,82,74,3,4,5,1,4,3,0,4,6,6
33,15/09/12,Norwich,West Ham,0,0,D,73,74,3,3,7,-5,6,3,1,4,2,2
34,15/09/12,QPR,Chelsea,0,0,D,75,81,3,2,9,-7,9,3,6,8,1,2
35,15/09/12,Stoke,Man City,1,1,D,75,82,3,5,3,0,7,3,3,8,3,3
36,15/09/12,Sunderland,Liverpool,1,1,D,75,79,3,7,2,0,1,2,-5,2,2,2
37,16/09/12,Reading,Tottenham,1,3,A,71,80,3,4,5,-2,2,2,-1,3,1,3
38,17/09/12,Everton,Newcastle,2,2,D,76,77,3,4,3,1,4,3,-1,3,6,4
39,22/09/12,Chelsea,Stoke,1,0,H,81,75,4,4,2,6,4,4,0,4,10,8
40,22/09/12,Southampton,Aston Villa,4,1,H,73,75,4,5,14,-9,4,4,-1,4,0,5
41,22/09/12,Swansea,Everton,0,3,A,74,76,4,5,4,6,7,4,1,6,7,10
42,22/09/12,West Brom,Reading,1,0,H,74,71,3,8,4,2,1,4,-4,4,7,6
43,22/09/12,West Ham,Sunderland,1,1,D,74,75,3,3,3,1,3,4,0,3,7,4
44,22/09/12,Wigan,Fulham,1,2,A,74,77,4,6,8,-4,6,4,4,10,4,4
45,23/09/12,Liverpool,Man United,1,2,A,79,82,4,5,8,-5,9,4,5,10,2,3
46,23/09/12,Man City,Arsenal,1,1,D,82,80,4,1,6,3,8,4,7,8,8,9
47,23/09/12,Newcastle,Norwich,1,0,H,77,73,4,7,6,-1,3,4,-5,2,5,5
48,23/09/12,Tottenham,QPR,2,1,H,80,75,4,9,5,1,2,4,-7,2,5,6
49,29/09/12,Arsenal,Chelsea,1,2,A,80,81,5,2,2,7,13,5,7,9,9,9
50,29/09/12,Everton,Southampton,3,1,H,76,73,5,15,5,4,3,5,-6,9,10,9
51,29/09/12,Fulham,Man City,1,2,A,77,82,5,7,7,5,9,5,3,10,9,12
52,29/09/12,Man United,Tottenham,2,3,A,82,80,5,6,6,6,8,5,2,8,12,12
53,29/09/12,Norwich,Liverpool,2,5,A,73,79,5,10,8,-6,2,5,-6,4,3,2
54,29/09/12,Reading,Newcastle,2,2,D,71,77,5,6,9,-5,8,4,0,6,1,4
55,29/09/12,Stoke,Swansea,2,0,H,75,74,5,7,5,-1,7,5,3,10,4,4
56,29/09/12,Sunderland,Wigan,1,0,H,75,74,5,10,4,0,4,4,-5,5,4,4
57,30/09/12,Aston Villa,West Brom,1,1,D,75,74,5,4,9,-4,10,5,3,7,4,5
58,01/10/12,QPR,West Ham,1,2,A,75,74,5,4,11,-8,8,5,1,5,2,3
59,06/10/12,Chelsea,Norwich,4,1,H,81,73,6,13,3,8,3,6,-9,4,16,11
60,06/10/12,Man City,Sunderland,3,0,H,82,75,5,4,8,4,7,6,1,5,12,12
61,06/10/12,Swansea,Reading,2,2,D,74,71,5,11,9,1,2,6,-5,6,7,10
62,06/10/12,West Brom,QPR,3,2,H,74,75,6,13,5,3,2,6,-9,4,11,8
63,06/10/12,West Ham,Arsenal,1,3,A,74,80,6,4,5,2,9,6,6,10,11,7
64,06/10/12,Wigan,Everton,2,2,D,74,76,6,6,11,-6,13,6,6,12,4,5
65,07/10/12,Liverpool,Stoke,0,0,D,79,75,6,5,12,-3,7,6,1,6,5,9
66,07/10/12,Newcastle,Man United,0,3,A,77,82,6,9,8,0,12,6,5,14,9,8
67,07/10/12,Southampton,Fulham,2,2,D,73,77,6,9,18,-8,9,6,4,13,3,10
68,07/10/12,Tottenham,Aston Villa,2,0,H,80,75,6,10,8,3,5,6,-4,6,11,11
69,20/10/12,Fulham,Aston Villa,1,0,H,77,75,7,12,11,4,5,7,-6,6,10,15
70,20/10/12,Liverpool,Reading,1,0,H,79,71,6,13,12,-3,3,7,-5,8,6,9
71,20/10/12,Man United,Stoke,4,2,H,82,75,7,5,9,8,8,7,1,6,15,17
72,20/10/12,Norwich,Arsenal,1,0,H,73,80,7,5,17,-12,12,7,8,13,3,5
73,20/10/12,Swansea,Wigan,2,1,H,74,74,7,13,11,1,5,7,-6,7,8,12
74,20/10/12,Tottenham,Chelsea,2,4,A,80,81,7,4,8,5,19,7,11,15,14,13
75,20/10/12,West Brom,Man City,1,2,A,74,82,7,8,7,4,15,7,7,15,14,11
76,20/10/12,West Ham,Southampton,4,1,H,74,73,7,20,8,0,4,7,-8,12,11,8
77,21/10/12,QPR,Everton,1,1,D,75,76,7,8,16,-10,14,7,6,14,2,6
78,21/10/12,Sunderland,Newcastle,1,1,D,75,77,7,11,7,-2,9,6,-3,8,7,5
79,27/10/12,Arsenal,QPR,1,0,H,80,75,8,17,6,7,3,8,-10,7,12,13
80,27/10/12,Aston Villa,Norwich,1,1,D,75,73,8,17,13,-7,6,8,-11,6,5,6
81,27/10/12,Man City,Swansea,1,0,H,82,74,8,12,9,8,11,8,2,14,18,17
82,27/10/12,Reading,Fulham,3,3,D,71,77,8,11,14,-6,13,7,5,16,3,8
83,27/10/12,Stoke,Sunderland,0,0,D,75,75,7,8,9,-1,8,8,-2,6,8,8
84,27/10/12,Wigan,West Ham,2,1,H,74,74,8,9,15,-7,14,8,3,12,5,8
85,28/10/12,Chelsea,Man United,2,3,A,81,82,8,11,6,13,18,8,10,21,22,19
86,28/10/12,Everton,Liverpool,2,2,D,76,79,8,12,9,6,9,8,-2,10,15,15
87,28/10/12,Newcastle,West Brom,2,1,H,77,74,8,9,12,-3,14,8,3,12,10,9
88,28/10/12,Southampton,Tottenham,1,2,A,73,80,8,12,24,-11,14,8,3,15,4,13
89,03/11/12,Fulham,Everton,2,2,D,77,76,9,11,14,5,16,9,6,17,14,19
90,03/11/12,Man United,Arsenal,2,1,H,82,80,9,6,13,11,15,9,8,14,21,24
91,03/11/12,Norwich,Stoke,1,0,H,73,75,9,9,18,-11,9,9,-1,8,7,7
92,03/11/12,Sunderland,Aston Villa,0,1,A,75,75,9,14,8,-2,6,8,-7,7,9,6
93,03/11/12,Swansea,Chelsea,1,1,D,74,81,9,9,13,1,22,9,12,21,11,14
94,03/11/12,Tottenham,Wigan,0,1,A,80,74,9,16,13,4,8,9,-6,10,17,17
95,03/11/12,West Ham,Man City,0,0,D,74,82,9,9,11,2,21,9,9,18,14,13
96,04/11/12,Liverpool,Newcastle,1,1,D,79,77,9,13,14,-2,13,9,-2,11,10,12
97,04/11/12,QPR,Reading,1,1,D,75,71,8,17,18,-11,4,9,-6,11,3,7
98,05/11/12,West Brom,Southampton,2,0,H,74,73,9,26,11,2,4,9,-12,14,14,13
99,10/11/12,Arsenal,Fulham,3,3,D,80,77,10,16,8,7,15,10,5,21,15,15
100,10/11/12,Aston Villa,Man United,2,3,A,75,82,10,14,14,-6,24,10,12,26,9,8
101,10/11/12,Everton,Sunderland,2,1,H,76,75,9,9,13,6,9,10,-3,6,17,19
102,10/11/12,Reading,Norwich,0,0,D,71,73,10,18,18,-6,10,9,-10,8,5,12
103,10/11/12,Southampton,Swansea,1,1,D,73,74,10,14,28,-14,12,10,1,15,4,14
104,10/11/12,Stoke,QPR,1,0,H,75,75,10,19,10,-2,4,10,-11,8,9,8
105,10/11/12,Wigan,West Brom,1,2,A,74,74,10,11,16,-5,17,10,4,15,11,11
106,11/11/12,Chelsea,Liverpool,1,1,D,81,79,10,15,10,12,11,10,-2,13,23,22
107,11/11/12,Man City,Tottenham,2,1,H,82,80,10,14,9,9,17,10,3,17,22,18
108,11/11/12,Newcastle,West Ham,0,1,A,77,74,10,11,14,-2,15,10,2,13,14,12
109,17/11/12,Arsenal,Tottenham,5,2,H,80,80,11,16,11,7,17,11,2,18,16,18
110,17/11/12,Liverpool,Wigan,3,0,H,79,74,11,18,16,-2,11,11,-6,12,12,14
111,17/11/12,Man City,Aston Villa,5,0,H,82,75,11,17,10,10,9,11,-7,10,25,20
112,17/11/12,Newcastle,Swansea,1,2,A,77,74,11,15,15,-3,13,11,1,16,14,12
113,17/11/12,Norwich,Man United,1,0,H,73,82,11,16,18,-10,27,11,13,29,11,8
114,17/11/12,QPR,Southampton,1,3,A,75,73,11,29,20,-12,5,11,-14,15,4,8
115,17/11/12,Reading,Everton,2,1,H,71,76,11,14,18,-6,20,10,7,21,6,12
116,17/11/12,West Brom,Chelsea,2,1,H,74,81,11,11,12,5,24,11,12,23,20,17
117,18/11/12,Fulham,Sunderland,1,3,A,77,75,10,11,19,5,9,11,-4,7,16,24
118,19/11/12,West Ham,Stoke,1,1,D,74,75,11,10,11,3,12,11,-1,9,18,14
119,24/11/12,Aston Villa,Arsenal,0,0,D,75,80,12,13,22,-12,19,12,10,23,9,10
120,24/11/12,Everton,Norwich,1,1,D,76,73,12,18,16,6,14,12,-9,9,20,22
121,24/11/12,Man United,QPR,3,1,H,82,75,12,23,17,12,4,12,-14,9,27,29
122,24/11/12,Stoke,Fulham,1,0,H,75,77,12,22,11,-1,16,12,3,25,13,10
123,24/11/12,Sunderland,West Brom,2,4,A,75,74,12,13,12,-2,23,11,6,19,12,10
124,24/11/12,Wigan,Reading,3,2,H,74,71,11,19,21,-9,9,12,-5,14,11,12
125,25/11/12,Chelsea,Man City,0,0,D,81,82,12,10,13,11,28,12,15,25,24,24
126,25/11/12,Southampton,Newcastle,2,0,H,73,77,12,17,30,-12,14,12,-4,13,8,18
127,25/11/12,Swansea,Liverpool,0,0,D,74,79,12,16,16,2,15,12,1,17,16,18
128,25/11/12,Tottenham,West Ham,3,1,H,80,74,12,12,21,-1,19,12,3,15,17,20
129,27/11/12,Aston Villa,Reading,1,0,H,75,71,12,22,22,-12,9,13,-6,16,10,10
130,27/11/12,Sunderland,QPR,0,0,D,75,75,13,26,16,-4,4,12,-16,10,12,12
131,28/11/12,Chelsea,Fulham,0,0,D,81,77,13,23,13,11,16,13,2,25,25,24
132,28/11/12,Everton,Arsenal,1,1,D,76,80,13,13,17,6,20,13,10,23,21,23
133,28/11/12,Man United,West Ham,1,0,H,82,74,13,15,18,14,19,13,1,16,30,32
134,28/11/12,Southampton,Norwich,1,1,D,73,73,13,19,30,-10,15,13,-9,10,11,20
135,28/11/12,Stoke,Newcastle,2,1,H,75,77,13,19,11,0,14,13,-6,13,16,11
136,28/11/12,Swansea,West Brom,3,1,H,74,74,13,15,16,2,26,13,8,23,17,18
137,28/11/12,Tottenham,Liverpool,2,1,H,80,79,13,16,22,1,16,13,1,17,20,23
138,28/11/12,Wigan,Man City,0,2,A,74,82,13,10,23,-8,29,13,15,25,14,15
139,01/12/12,Arsenal,Swansea,0,2,A,80,74,14,17,14,10,20,14,4,21,21,24
140,01/12/12,Fulham,Tottenham,0,3,A,77,80,14,23,23,2,23,14,2,25,17,25
141,01/12/12,Liverpool,Southampton,1,0,H,79,73,14,31,18,0,12,14,-10,21,16,18
142,01/12/12,Man City,Everton,1,1,D,82,76,14,18,10,17,22,14,6,24,32,27
143,01/12/12,QPR,Aston Villa,1,1,D,75,75,14,22,26,-16,13,14,-11,11,5,10
144,01/12/12,Reading,Man United,3,4,A,71,82,14,18,23,-7,33,13,15,33,9,16
145,01/12/12,West Brom,Stoke,0,1,A,74,75,14,12,18,6,19,14,1,13,26,24
146,01/12/12,West Ham,Chelsea,3,1,H,74,81,14,13,16,0,26,14,11,24,19,16
147,02/12/12,Norwich,Sunderland,2,1,H,73,75,13,16,20,-9,13,14,-4,12,16,11
148,03/12/12,Newcastle,Wigan,3,0,H,77,74,14,25,21,-7,14,14,-10,15,14,14
149,08/12/12,Arsenal,West Brom,2,0,H,80,74,15,19,16,8,26,15,5,24,21,24
150,08/12/12,Aston Villa,Stoke,0,0,D,75,75,15,12,23,-11,22,15,2,14,14,12
151,08/12/12,Southampton,Reading,1,0,H,73,71,14,27,32,-11,9,15,-8,19,12,21
152,08/12/12,Sunderland,Chelsea,1,3,A,75,81,15,16,18,-5,26,14,9,25,13,13
153,08/12/12,Swansea,Norwich,3,4,A,74,73,15,21,17,6,19,15,-8,13,23,23
154,08/12/12,Wigan,QPR,2,2,D,74,75,15,27,28,-13,6,15,-16,11,14,15
155,09/12/12,Everton,Tottenham,2,1,H,76,80,15,23,19,6,26,15,5,28,23,25
156,09/12/12,Man City,Man United,2,3,A,82,82,15,21,11,17,36,15,16,37,33,28
157,09/12/12,West Ham,Liverpool,2,3,A,74,79,15,18,17,2,19,15,1,19,22,19
158,10/12/12,Fulham,Newcastle,2,1,H,77,77,15,21,26,-1,17,15,-4,17,17,25
159,11/12/12,Sunderland,Reading,3,0,H,75,71,15,28,21,-7,9,15,-9,19,13,14
160,15/12/12,Liverpool,Aston Villa,1,3,A,79,75,16,23,20,2,15,16,-11,12,22,22
161,15/12/12,Man United,Sunderland,3,1,H,82,75,16,21,23,17,16,16,-4,17,39,40
162,15/12/12,Newcastle,Man City,1,3,A,77,82,16,14,23,-5,33,16,16,30,17,18
163,15/12/12,Norwich,Wigan,2,1,H,73,74,16,30,24,-7,15,16,-13,17,22,17
164,15/12/12,QPR,Fulham,2,1,H,75,77,16,27,29,-16,20,16,0,27,7,13
165,15/12/12,Stoke,Everton,1,1,D,75,76,16,20,12,2,26,16,7,27,23,14
166,16/12/12,Tottenham,Swansea,1,0,H,80,74,16,21,25,4,23,16,5,26,26,29
167,16/12/12,West Brom,West Ham,0,0,D,74,74,16,20,21,3,22,16,1,21,26,24
168,17/12/12,Reading,Arsenal,2,5,A,71,80,16,16,31,-12,24,16,10,26,9,19
169,22/12/12,Liverpool,Fulham,4,0,H,79,77,17,29,23,0,20,17,-1,28,22,23
170,22/12/12,Man City,Reading,1,0,H,82,71,17,36,15,18,9,17,-15,21,36,33
171,22/12/12,Newcastle,QPR,1,0,H,77,75,17,30,26,-7,10,17,-15,15,17,19
172,22/12/12,Southampton,Sunderland,0,1,A,73,75,17,24,32,-10,16,16,-6,18,15,22
173,22/12/12,Tottenham,Stoke,0,0,D,80,75,17,13,25,5,24,17,2,15,29,30
174,22/12/12,West Brom,Norwich,2,1,H,74,73,17,25,21,3,25,17,-6,19,27,24
175,22/12/12,West Ham,Everton,1,2,A,74,76,17,21,20,1,27,17,7,28,23,21
176,22/12/12,Wigan,Arsenal,0,1,A,74,80,17,18,32,-14,27,17,13,31,15,18
177,23/12/12,Chelsea,Aston Villa,8,0,H,81,75,17,24,17,11,18,16,-9,15,29,28
178,23/12/12,Swansea,Man United,1,1,D,74,82,17,24,22,4,42,17,19,43,23,26
179,26/12/12,Aston Villa,Tottenham,0,4,A,75,80,18,25,32,-17,30,18,5,30,18,15
180,26/12/12,Everton,Wigan,2,1,H,76,74,18,33,22,8,15,18,-15,18,30,30
181,26/12/12,Fulham,Southampton,1,1,D,77,73,17,33,33,-5,15,18,-11,22,20,28
182,26/12/12,Man United,Newcastle,4,3,H,82,77,18,26,25,19,20,18,-6,20,43,44
183,26/12/12,Norwich,Chelsea,0,1,A,73,81,17,17,27,-7,32,18,19,36,25,20
184,26/12/12,QPR,West Brom,1,2,A,75,74,18,22,31,-16,30,18,4,26,10,15
185,26/12/12,Reading,Swansea,0,0,D,71,74,18,23,37,-16,24,18,4,27,9,21
186,26/12/12,Stoke,Liverpool,3,1,H,75,79,18,23,13,2,25,18,4,27,25,15
187,26/12/12,Sunderland,Man City,1,0,H,75,82,18,15,24,-5,39,18,19,34,19,19
188,29/12/12,Arsenal,Newcastle,7,3,H,80,77,19,30,18,14,20,18,-7,23,30,32
189,29/12/12,Aston Villa,Wigan,0,3,A,75,74,19,35,36,-21,15,19,-16,19,18,15
190,29/12/12,Fulham,Swansea,1,2,A,77,74,19,23,34,-5,25,19,4,27,21,29
191,29/12/12,Man United,West Brom,2,0,H,82,74,19,23,28,20,33,19,5,28,46,48
192,29/12/12,Norwich,Man City,3,4,A,73,82,19,16,28,-8,39,19,18,34,25,20
193,29/12/12,Reading,West Ham,1,0,H,71,74,18,22,37,-16,23,19,0,22,10,21
194,29/12/12,Stoke,Southampton,3,3,D,75,73,18,34,14,4,16,19,-11,23,28,18
195,29/12/12,Sunderland,Tottenham,1,2,A,75,80,19,25,24,-4,33,19,9,34,22,20
196,30/12/12,Everton,Chelsea,1,2,A,76,81,18,17,23,9,35,19,20,37,33,32
197,30/12/12,QPR,Liverpool,0,3,A,75,79,19,26,33,-17,25,19,2,28,10,16
198,01/01/13,Man City,Stoke,3,0,H,82,75,20,17,19,19,29,20,4,21,42,38
199,01/01/13,Southampton,Arsenal,1,1,D,73,80,19,21,37,-11,33,19,18,39,17,26
200,01/01/13,Swansea,Aston Villa,2,2,D,74,75,20,39,24,5,18,20,-24,15,28,29
201,01/01/13,Tottenham,Reading,3,1,H,80,71,20,37,26,10,13,20,-15,22,36,36
202,01/01/13,West Brom,Fulham,1,2,A,74,77,20,36,25,3,21,20,-6,30,33,28
203,01/01/13,West Ham,Norwich,2,1,H,74,73,20,32,23,-1,25,19,-9,23,23,22
204,01/01/13,Wigan,Man United,0,4,A,74,82,20,28,35,-13,49,20,22,50,18,22
205,02/01/13,Chelsea,QPR,0,1,A,81,75,20,36,18,21,10,19,-20,16,38,39
206,02/01/13,Liverpool,Sunderland,3,0,H,79,75,20,26,26,5,22,20,-5,21,28,31
207,02/01/13,Newcastle,Everton,1,2,A,77,76,20,25,37,-11,33,20,8,33,20,26
208,12/01/13,Aston Villa,Southampton,0,1,A,75,73,20,38,41,-24,18,21,-11,27,19,17
209,12/01/13,Everton,Swansea,0,0,D,76,74,21,26,26,9,29,21,5,31,36,35
210,12/01/13,Fulham,Wigan,1,1,D,77,74,21,39,37,-5,18,21,-17,22,24,32
211,12/01/13,Norwich,Newcastle,0,0,D,73,77,21,39,34,-10,20,21,-12,27,25,24
212,12/01/13,QPR,Tottenham,0,0,D,75,80,21,27,36,-19,39,21,12,39,13,17
213,12/01/13,Reading,West Brom,3,2,H,71,74,21,27,40,-17,33,21,2,29,13,23
214,12/01/13,Stoke,Chelsea,0,4,A,75,81,20,19,20,1,38,21,20,39,29,21
215,12/01/13,Sunderland,West Ham,3,0,H,75,74,20,24,29,-8,26,21,0,24,22,21
216,13/01/13,Arsenal,Man City,0,2,A,80,82,21,19,22,18,45,20,22,41,34,40
217,13/01/13,Man United,Liverpool,2,1,H,82,79,21,26,28,26,31,21,8,34,52,54
218,16/01/13,Chelsea,Southampton,2,2,D,81,73,21,38,19,24,21,21,-10,28,41,43
219,19/01/13,Liverpool,Norwich,5,0,H,79,73,22,34,28,7,26,22,-10,24,31,35
220,19/01/13,Man City,Fulham,2,0,H,82,77,22,38,19,24,25,22,-5,33,48,43
221,19/01/13,Newcastle,Reading,1,2,A,77,71,22,42,39,-12,16,22,-16,26,21,27
222,19/01/13,Swansea,Stoke,3,1,H,74,75,22,24,26,5,29,22,-3,21,30,31
223,19/01/13,West Brom,Aston Villa,2,2,D,74,75,22,42,30,1,19,22,-25,17,33,31
224,19/01/13,West Ham,QPR,1,1,D,74,75,22,36,27,-3,14,21,-19,17,26,24
225,19/01/13,Wigan,Sunderland,2,3,A,74,75,22,29,40,-17,25,22,-5,24,19,23
226,20/01/13,Chelsea,Arsenal,2,1,H,81,80,21,24,21,24,34,22,16,40,42,45
227,20/01/13,Tottenham,Man United,1,1,D,80,82,22,29,27,12,55,22,27,56,40,39
228,21/01/13,Southampton,Everton,0,0,D,73,76,22,26,40,-10,37,22,9,35,22,30
229,23/01/13,Arsenal,West Ham,5,1,H,80,74,22,28,26,15,27,22,-3,25,34,41
230,29/01/13,Aston Villa,Newcastle,1,2,A,75,77,23,41,44,-25,21,23,-13,28,20,19
231,29/01/13,QPR,Man City,0,0,D,75,82,23,19,37,-19,51,23,26,45,15,18
232,29/01/13,Stoke,Wigan,2,2,D,75,74,23,43,27,-5,19,23,-18,25,29,22
233,29/01/13,Sunderland,Swansea,0,0,D,75,74,23,27,31,-4,33,23,7,34,28,27
234,30/01/13,Arsenal,Liverpool,2,2,D,80,79,23,28,27,19,34,23,12,40,37,46
235,30/01/13,Everton,West Brom,2,1,H,76,74,23,32,26,9,34,23,1,33,38,35
236,30/01/13,Fulham,West Ham,3,1,H,77,74,23,33,40,-7,27,23,-7,26,25,33
237,30/01/13,Man United,Southampton,2,1,H,82,73,23,40,30,27,23,23,-10,30,56,57
238,30/01/13,Norwich,Tottenham,1,1,D,73,80,23,28,39,-15,41,23,12,40,26,24
239,30/01/13,Reading,Chelsea,2,2,D,71,81,23,22,43,-15,45,23,25,47,19,28
240,02/02/13,Arsenal,Stoke,1,0,H,80,75,24,29,29,19,30,24,-5,24,38,48
241,02/02/13,Everton,Aston Villa,3,3,D,76,75,24,46,27,10,20,24,-26,20,41,37
242,02/02/13,Fulham,Man United,0,1,A,77,82,24,31,41,-5,59,24,28,59,28,36
243,02/02/13,Newcastle,Chelsea,3,2,H,77,81,24,24,42,-12,46,24,25,49,24,30
244,02/02/13,QPR,Norwich,0,0,D,75,73,24,40,37,-19,27,24,-15,25,16,18
245,02/02/13,Reading,Sunderland,2,1,H,71,75,24,31,45,-15,29,24,-4,27,20,30
246,02/02/13,West Ham,Swansea,1,0,H,74,74,24,27,36,-9,34,24,7,34,27,27
247,02/02/13,Wigan,Southampton,2,2,D,74,73,24,42,45,-18,23,24,-11,31,20,27
248,03/02/13,Man City,Liverpool,2,2,D,82,79,24,30,19,26,35,24,12,42,52,45
249,03/02/13,West Brom,Tottenham,0,1,A,74,80,24,29,34,0,42,24,12,41,34,34
250,09/02/13,Chelsea,Wigan,4,1,H,81,74,25,47,27,24,21,25,-18,29,46,51
251,09/02/13,Norwich,Fulham,0,0,D,73,77,25,42,40,-15,28,25,-6,36,28,25
252,09/02/13,Southampton,Man City,3,1,H,73,82,25,21,44,-11,53,25,26,47,24,33
253,09/02/13,Stoke,Reading,2,1,H,75,71,25,46,30,-6,23,25,-14,32,30,24
254,09/02/13,Sunderland,Arsenal,0,1,A,75,80,25,29,33,-5,41,25,20,49,29,28
255,09/02/13,Swansea,QPR,4,1,H,74,75,25,37,28,6,17,25,-19,18,34,34
256,09/02/13,Tottenham,Newcastle,2,1,H,80,77,25,44,29,13,27,25,-11,33,45,42
257,10/02/13,Aston Villa,West Ham,2,1,H,75,74,25,36,49,-26,30,25,-8,28,21,23
258,10/02/13,Man United,Everton,2,0,H,82,76,25,30,31,29,42,25,10,40,62,60
259,11/02/13,Liverpool,West Brom,0,2,A,79,74,25,35,32,12,34,25,-1,34,36,44
260,17/02/13,Liverpool,Swansea,5,0,H,79,74,26,29,34,10,37,26,9,38,36,44
261,23/02/13,Arsenal,Aston Villa,2,1,H,80,75,26,50,29,21,24,26,-25,25,44,50
262,23/02/13,Fulham,Stoke,1,0,H,77,75,26,31,42,-6,33,26,-5,26,29,36
263,23/02/13,Norwich,Everton,2,1,H,73,76,26,32,40,-15,42,26,8,40,29,25
264,23/02/13,QPR,Man United,0,2,A,75,82,26,31,41,-22,65,26,31,62,17,19
265,23/02/13,Reading,Wigan,0,3,A,71,74,26,51,48,-15,21,26,-21,30,23,33
266,23/02/13,West Brom,Sunderland,2,1,H,74,75,26,34,35,1,29,26,-6,28,37,36
267,24/02/13,Man City,Chelsea,2,0,H,82,81,26,28,24,24,49,26,27,55,53,48
268,24/02/13,Newcastle,Southampton,4,2,H,77,73,26,45,46,-12,27,26,-9,36,27,34
269,25/02/13,West Ham,Tottenham,2,3,A,74,80,26,30,38,-9,48,26,14,44,30,29
270,02/03/13,Chelsea,West Brom,1,0,H,81,74,27,36,30,25,40,27,2,38,49,55
271,02/03/13,Everton,Reading,3,1,H,76,71,27,51,34,7,23,27,-18,33,42,41
272,02/03/13,Man United,Norwich,4,0,H,82,73,27,41,31,33,32,27,-14,27,68,64
273,02/03/13,Southampton,QPR,1,2,A,73,75,27,43,49,-11,17,27,-24,19,27,38
274,02/03/13,Stoke,West Ham,0,1,A,75,74,27,41,32,-6,30,27,-10,31,33,26
275,02/03/13,Sunderland,Fulham,2,2,D,75,77,27,42,36,-7,32,27,-5,37,29,29
276,02/03/13,Swansea,Newcastle,1,0,H,74,77,27,48,34,4,30,27,-10,38,37,38
277,02/03/13,Wigan,Liverpool,0,4,A,74,79,27,34,51,-18,39,27,15,49,24,33
278,03/03/13,Tottenham,Arsenal,2,1,H,80,80,27,30,32,15,47,27,22,52,51,47
279,04/03/13,Aston Villa,Man City,0,1,A,75,82,27,24,52,-26,56,27,26,50,24,26
280,09/03/13,Norwich,Southampton,0,0,D,73,73,28,51,45,-18,27,28,-12,39,32,27
281,09/03/13,QPR,Sunderland,3,1,H,75,75,28,38,44,-23,30,28,-7,31,20,21
282,09/03/13,Reading,Aston Villa,1,2,A,71,75,28,53,54,-20,24,28,-27,26,23,34
283,09/03/13,West Brom,Swansea,2,1,H,74,74,28,34,37,1,40,28,5,39,40,38
284,10/03/13,Liverpool,Tottenham,3,2,H,79,80,28,33,34,19,54,28,16,49,42,53
285,10/03/13,Newcastle,Stoke,2,1,H,77,75,28,33,49,-11,33,28,-7,26,30,38
286,16/03/13,Aston Villa,QPR,3,2,H,75,75,29,45,54,-26,23,29,-21,24,27,28
287,16/03/13,Everton,Man City,2,0,H,76,82,28,24,35,9,59,28,27,51,45,44
288,16/03/13,Man United,Reading,1,0,H,82,71,29,56,31,37,23,28,-21,35,71,68
289,16/03/13,Southampton,Liverpool,3,1,H,73,79,29,36,51,-12,45,29,20,56,28,39
290,16/03/13,Stoke,West Brom,0,0,D,75,74,29,38,35,-8,43,29,2,40,33,27
291,16/03/13,Swansea,Arsenal,0,2,A,74,80,28,32,36,4,47,29,21,53,40,40
292,17/03/13,Chelsea,West Ham,2,0,H,81,74,28,41,30,26,33,28,-9,32,52,56
293,17/03/13,Sunderland,Norwich,1,1,D,75,73,29,45,41,-9,33,29,-18,27,30,32
294,17/03/13,Tottenham,Fulham,0,1,A,80,77,28,44,36,15,33,29,-5,39,54,51
295,17/03/13,Wigan,Newcastle,2,1,H,74,77,29,50,55,-22,33,28,-10,40,24,33
296,30/03/13,Arsenal,Reading,4,1,H,80,71,30,57,32,23,23,29,-22,35,50,55
297,30/03/13,Everton,Stoke,1,0,H,76,75,30,35,35,11,34,29,-8,27,48,46
298,30/03/13,Man City,Newcastle,4,0,H,82,77,30,52,26,25,33,29,-11,41,59,51
299,30/03/13,Southampton,Chelsea,2,1,H,73,81,29,30,52,-10,55,30,28,58,31,42
300,30/03/13,Sunderland,Man United,0,1,A,75,82,29,31,42,-9,74,30,38,69,31,33
301,30/03/13,Swansea,Tottenham,1,2,A,74,80,30,37,38,2,54,30,14,51,40,40
302,30/03/13,West Ham,West Brom,3,1,H,74,74,30,38,43,-11,44,29,2,40,33,32
303,30/03/13,Wigan,Norwich,1,0,H,74,73,30,46,56,-21,34,29,-18,28,27,35
304,31/03/13,Aston Villa,Liverpool,1,2,A,75,79,30,39,56,-25,45,30,18,57,30,31
305,01/04/13,Fulham,QPR,3,2,H,77,75,30,48,44,-4,23,29,-22,26,36,40
306,06/04/13,Norwich,Swansea,2,2,D,73,74,31,40,47,-19,40,31,1,41,34,28
307,06/04/13,Reading,Southampton,0,2,A,71,73,31,53,61,-25,34,31,-9,44,23,36
308,06/04/13,Stoke,Aston Villa,1,3,A,75,75,31,58,36,-9,30,31,-26,32,34,27
309,06/04/13,West Brom,Arsenal,1,2,A,74,80,30,33,41,0,53,31,26,59,44,41
310,07/04/13,Chelsea,Sunderland,2,1,H,81,75,31,43,32,27,31,30,-10,33,55,59
311,07/04/13,Liverpool,West Ham,0,0,D,79,74,30,44,40,19,36,31,-9,35,48,59
312,07/04/13,Newcastle,Fulham,1,0,H,77,77,30,46,56,-15,39,31,-3,43,33,41
313,07/04/13,QPR,Wigan,1,1,D,75,74,30,56,51,-23,30,31,-20,36,23,28
314,07/04/13,Tottenham,Everton,2,2,D,80,76,30,35,38,15,51,31,12,47,57,53
315,08/04/13,Man United,Man City,1,2,A,82,82,30,26,31,39,62,30,29,55,77,70
316,13/04/13,Arsenal,Norwich,3,1,H,80,73,32,49,34,27,35,31,-19,30,56,61
317,13/04/13,Aston Villa,Fulham,1,1,D,75,77,31,47,59,-24,39,32,-4,43,33,35
318,13/04/13,Everton,QPR,2,0,H,76,75,32,52,37,12,24,31,-23,29,52,49
319,13/04/13,Reading,Liverpool,0,0,D,71,79,32,40,63,-27,49,32,19,59,23,36
320,13/04/13,Southampton,West Ham,1,1,D,73,74,31,44,53,-7,37,32,-9,35,37,46
321,14/04/13,Newcastle,Sunderland,0,3,A,77,75,32,45,56,-14,31,32,-11,34,36,42
322,14/04/13,Stoke,Man United,0,2,A,75,82,31,33,39,-11,77,32,38,71,34,28
323,16/04/13,Arsenal,Everton,0,0,D,80,76,32,37,35,29,55,32,14,51,59,64
324,17/04/13,Fulham,Chelsea,0,3,A,77,81,31,33,48,-4,58,32,28,61,40,44
325,17/04/13,Man City,Wigan,1,0,H,82,74,31,57,27,30,31,31,-20,37,65,57
326,17/04/13,West Ham,Man United,2,2,D,74,82,32,33,45,-9,80,32,40,73,38,36
327,20/04/13,Fulham,Arsenal,0,1,A,77,80,33,35,51,-7,60,33,29,64,40,44
328,20/04/13,Norwich,Reading,2,1,H,73,71,33,63,52,-21,24,33,-27,36,35,31
329,20/04/13,QPR,Stoke,0,2,A,75,75,33,41,54,-25,34,33,-13,28,24,29
330,20/04/13,Sunderland,Everton,1,0,H,75,76,33,37,45,-8,56,33,14,51,34,37
331,20/04/13,Swansea,Southampton,0,0,D,74,73,33,54,42,1,38,32,-7,47,41,43
332,20/04/13,West Brom,Newcastle,1,1,D,74,77,33,59,43,-1,36,32,-17,42,44,42
333,20/04/13,West Ham,Wigan,2,0,H,74,74,32,58,47,-9,31,33,-21,37,39,38
334,21/04/13,Liverpool,Chelsea,2,2,D,79,81,32,33,40,19,61,33,31,64,50,59
335,21/04/13,Tottenham,Man City,3,1,H,80,82,32,27,40,15,68,32,31,58,58,55
336,22/04/13,Man United,Aston Villa,3,0,H,82,75,33,60,35,40,34,33,-24,36,81,75
337,27/04/13,Everton,Fulham,1,0,H,76,77,34,52,38,13,40,34,-8,44,56,51
338,27/04/13,Man City,West Ham,2,1,H,82,74,34,47,30,29,42,33,-7,40,68,59
339,27/04/13,Newcastle,Liverpool,0,6,A,77,79,34,42,60,-17,51,34,19,61,37,43
340,27/04/13,Southampton,West Brom,0,3,A,73,74,33,44,54,-7,45,34,-1,43,39,47
341,27/04/13,Stoke,Norwich,1,0,H,75,73,34,53,41,-11,38,34,-20,33,37,30
342,27/04/13,Wigan,Tottenham,2,2,D,74,80,33,41,60,-23,61,33,17,58,31,37
343,28/04/13,Arsenal,Man United,1,1,D,80,82,34,35,35,30,84,34,43,78,63,65
344,28/04/13,Chelsea,Swansea,2,0,H,81,74,33,42,35,31,42,33,1,43,62,66
345,28/04/13,Reading,QPR,0,0,D,71,75,34,56,65,-28,24,34,-27,29,24,37
346,29/04/13,Aston Villa,Sunderland,6,1,H,75,75,34,45,63,-27,37,34,-7,38,34,36
347,04/05/13,Fulham,Reading,2,4,A,77,71,35,65,53,-9,25,35,-28,37,40,44
348,04/05/13,Norwich,Aston Villa,1,2,A,73,75,35,64,54,-21,37,35,-22,42,38,33
349,04/05/13,QPR,Arsenal,0,1,A,75,80,35,36,56,-27,64,35,30,66,25,29
350,04/05/13,Swansea,Man City,0,0,D,74,82,34,31,44,-1,71,34,30,61,42,43
351,04/05/13,Tottenham,Southampton,1,0,H,80,73,35,57,43,17,39,34,-10,47,62,60
352,04/05/13,West Brom,Wigan,2,3,A,74,74,34,62,44,2,32,34,-23,39,48,46
353,04/05/13,West Ham,Newcastle,0,0,D,74,77,35,66,49,-8,37,35,-23,43,42,41
354,05/05/13,Liverpool,Everton,0,0,D,79,76,35,38,42,25,59,35,14,52,54,67
355,05/05/13,Man United,Chelsea,0,1,A,82,81,34,35,36,43,65,35,33,68,85,79
356,06/05/13,Sunderland,Stoke,1,1,D,75,75,35,41,51,-12,40,35,-10,31,37,39
357,07/05/13,Man City,West Brom,1,0,H,82,74,35,47,31,30,48,35,1,48,72,61
358,07/05/13,Wigan,Swansea,2,3,A,74,74,35,44,64,-22,43,35,-1,43,35,42
359,08/05/13,Chelsea,Tottenham,2,2,D,81,80,35,43,35,34,65,35,18,61,68,69
360,11/05/13,Aston Villa,Chelsea,1,2,A,75,81,36,37,65,-21,69,36,34,71,40,44
361,12/05/13,Everton,West Ham,2,0,H,76,74,36,49,38,14,43,36,-8,41,60,52
362,12/05/13,Fulham,Liverpool,1,3,A,77,79,36,42,57,-11,55,36,25,67,40,46
363,12/05/13,Man United,Swansea,2,1,H,82,74,36,46,37,42,46,36,0,46,85,79
364,12/05/13,Norwich,West Brom,4,0,H,73,74,36,48,56,-22,48,36,0,48,38,34
365,12/05/13,QPR,Newcastle,1,2,A,75,77,36,66,57,-28,38,36,-23,43,25,29
366,12/05/13,Stoke,Tottenham,1,2,A,75,80,36,45,42,-10,66,36,18,63,41,32
367,12/05/13,Sunderland,Southampton,1,1,D,75,73,36,58,52,-12,39,36,-11,47,38,40
368,14/05/13,Arsenal,Wigan,4,1,H,80,74,36,67,36,31,35,36,-23,44,67,67
369,14/05/13,Reading,Man City,0,2,A,71,82,36,31,67,-26,75,36,31,62,28,41
370,19/05/13,Chelsea,Everton,2,1,H,81,76,37,38,38,35,63,37,16,54,72,73
371,19/05/13,Liverpool,QPR,1,0,H,79,75,37,59,43,27,25,37,-29,30,58,70
372,19/05/13,Man City,Norwich,2,3,A,82,73,37,56,31,33,41,37,-18,38,78,64
373,19/05/13,Newcastle,Arsenal,0,1,A,77,80,37,37,67,-22,70,37,34,71,41,45
374,19/05/13,Southampton,Stoke,1,1,D,73,75,37,44,59,-11,41,37,-11,33,40,48
375,19/05/13,Swansea,Fulham,0,3,A,74,77,37,60,48,-1,40,37,-13,47,46,47
376,19/05/13,Tottenham,Sunderland,1,0,H,80,75,37,53,46,19,39,37,-12,41,69,65
377,19/05/13,West Brom,Man United,5,5,D,74,82,37,38,52,-4,88,37,43,81,48,48
378,19/05/13,West Ham,Reading,4,2,H,74,71,37,69,51,-10,28,37,-28,41,43,41
379,19/05/13,Wigan,Aston Villa,2,2,D,74,75,37,67,71,-26,40,37,-22,45,35,45
